吸	基本义	吸收	一个常见的汉字使用频率较高基本义为吸收。
撮	字义	取、摘取	基本字义：取、摘取；用手指捏取细碎的东西；量词；中国市制容量单位，一升的千分之一；撮东西用的器具；聚起，多指用簸箕状的器具铲起东西。
擢	造字法	形声	拼音：zhuó注音：ㄓㄨㄛˇ繁体字：擢汉字结构：左右结构造字法：形声简体部首：扌部首笔画：3总笔画：17笔顺：横竖横折捺横折捺横撇竖捺横横横竖横。
垟	造字法	羊声	声母：y字头：垟造字法：形声；从土、羊声四笔号码：7187五笔：fudh注音：yáng摘要：yang笔画：09画部首画：03部首：土部结构：左右结构。
擥	意思	一把抓、上来	擥，同“揽”。有总揽，一把抓、上来等意思。
鞜	意思	鼓声	鞜是一个字，基本意思是皮鞋，鼓声。
围	常见意义	四周拦挡起来	围，有多种解释，常见意义为，环绕，四周拦挡起来；圈起来作拦阻或遮挡的东西。
屈	用法	名词、动词	屈基本含义是使弯曲，与伸相对，也有竭，穷尽的意思，也可作姓氏。有名词、动词，形容词等用法。
怏	含义	不服气	怏（yàng）的含义有两种。1、不服气，不满意：～～不乐（形容不满意的神情）。
愚	本义	性格孤僻	愚，本义：性格孤僻，不谙熟人情世事。
润	本义	雨水下流	本义：雨水下流，滋润万物。
竭	本义	举重	竭(形声。字从立，从曷，曷亦声。“曷”意为“胸部”、“胸部起伏”。“立”指“站起来”。“立”与“曷”联合起来表示“身负重物站立起来”。本义：举重、负重。
戎	基本解释	武器	戎，汉字。拼音：róng，笔画6笔。基本解释为：兵器，武器，军队，军事。
炯	解释	炯然	读音：jiǒng解释：明亮、炯然部首：火部部外笔画：5总笔画数：9。
锾	解释	钱币	锾，汉字，读作huan，解释为古代重量单位、钱币等。
汾	基本字义	在中国山西省	字形字义汾Fénfén基本信息部首：氵部外笔画：4总笔画：7五笔86:IWVN五笔98:IWVT仓颉:ECSH郑码:VOYD笔顺编号:4413453四角号码：38127UniCode:CJK统一汉字U+6C7E基本字义fénㄈㄣˊ〔～河〕水名，在中国山西省。
粽	又叫	角黍	又叫角黍，俗称粽子。
胆	功能	贮存和排泄胆汁	主要功能为贮存和排泄胆汁，并参与饮食物的消化。
彩虹小镇	功能	购	彩虹小镇集科普教育、观光旅游、特色农产品销售、种植采摘、休闲养生为一体，具备吃、住、玩、购、教等功能，是具有高水平的经济效益、生态效益和社会效益的综合性多功能园区。
格斗刀	功能	割	格斗刀是野外战术的一种工具，常被用来户外或者野外生存所用，同时也被军人所喜好，格斗刀具有切、割、刺、砍功能，最大程度是为了发挥刺的优势。
自动烹饪锅	功能	焖	自动烹饪锅可以干炒、红烧、焖、蒸、煮、炖、煲等一锅多用的功能。
竭	说明	“尽”	竭(形声。字从立，从曷，曷亦声。“曷”意为“胸部”、“胸部起伏”。“立”指“站起来”。“立”与“曷”联合起来表示“身负重物站立起来”。本义：举重、负重。引申义：用力到达极限。说明：本字用同“极”、“尽”。
莺	释名	黄鸟	莺释名又叫黄鸟、黄鹂、仓庚、青鸟。
靛	植物	多年生草本	2.蓝靛，为爵床科植物马蓝BaphicacanthuscusiaBrem的叶经加工制得的粉末或团块，可作染料。药用时可用于温毒、发斑、血热吐衄、胸痛咳血、口疮、痄腮、喉痹、小儿惊痫等症状。植物形态多年生草本。
锆	化合价	+2	锆（Zirconium）是一种化学元素，它的化学符号是Zr，它的原子序数是40，是一种银白色的高熔点金属之一，呈浅灰色。密度6.49克/立方厘米。熔点1852±2℃，沸点4377℃。化合价+2、+3和+4。
锆	沸点	4377℃	锆（Zirconium）是一种化学元素，它的化学符号是Zr，它的原子序数是40，是一种银白色的高熔点金属之一，呈浅灰色。密度6.49克/立方厘米。熔点1852±2℃，沸点4377℃。
鲃	原产	欧洲	鲤科鲃属的一大类淡水鱼[barb]。原产欧洲、非洲及亚洲，典型种类的口周有一对或多对须，鳞大而亮。
鲊	部首	鱼部外	鲊：zhǎ部首笔画部首：鱼部外笔画：5总笔画：13五笔86:QGTF五笔98:QGTF仓颉：NMOS笔顺编号：3525121131211四角号码：28111Unicode:CJK统一汉字U+9C8A字形结构繁体字：鮓汉字首尾分解：鱼乍汉字部件分解：鱼乍笔顺读写：撇折竖折横竖横横撇横竖横横基本字义1.一种用盐和红曲腌的鱼：“江南人好作盘游饭，～脯脍炙，无有不埋在饭中”。
鲌	分布	湖泊都有	硬骨鱼纲鲤形目(Cypriniformes)鲤科(Cyprinidae)鲌亚科(Culterinae)鱼类的统称，又名白鱼。生活在江河湖泊的中型经济鱼类。在中国分布很广，除西北高原外，各江、河、湖泊都有，也见于苏联及朝鲜，图们江与鸭绿江无。
鲥	分布	中国	鲱科鱼，体侧扁，长70厘米，银白色，分布于中国、朝鲜、菲律宾沿海，是一种名贵食用鱼鲥鱼为溯河产卵的洄游性鱼类，因每年定时初夏时候入江，其他时间不出现，因此得名。
鲭	分布	热带海域	鲭，鱼类的一科，身体呈梭形而侧扁，鳞圆而细小，头尖，口大。分布在全世界温、热带海域，集成群活动。
谙	基本意思	熟悉	谙是一个汉字，基本意思是熟悉，精通。
铌	化学符号	Nb	化学符号Nb，原子序数41，原子量92.90638，属周期系ⅤB族。1801年英国C.哈切特从铌铁矿中分离出一种新元素的氧化物，并命名该元素为columbium（中译名钶）。
蔫	常见字义	有枯萎	蔫，汉字，读作niān，常见字义有枯萎、下垂的样子等。
粟	颜色	黄	粟生长耐旱，品种繁多，俗称“粟有五彩”，有白、红、黄、黑、橙、紫各种颜色的小米，也有粘性小米。中国最早的酒也是用小米酿造的。粟适合在干旱而缺乏灌溉的地区生长。其茎、叶较坚硬，可以作饲料，一般只有牛能消化。粟在中国北方俗称谷子。
临朐彩石	颜色	绿	临朐彩石，品种繁多，以其画面颜色和特点的不同，可分为五彩石、披绿石、水纹波浪石、藻化石、倒影石、竹子石、黑白玉石、古画石等品种。
开氅	颜色	黑	开氅的颜色有红、杏黄、蓝、白、黑、紫、绿、粉红、古铜、天蓝、草绿等，可以鲜艳轻快，也可以辉煌沉着。这些颜色的用法跟人物没有什么直接的关系。
奥林匹克环	颜色	红	奥林匹克标志，由五个奥林匹克环组成，环的颜色自左至右为蓝、黄、黑、绿、红（也可用单色绘制）。
塔吉克国旗	颜色	红	塔吉克国旗，主要颜色是红、白、绿三色。
无彩色	颜色	灰	无彩色（achromaticcolor）指除了彩色以外的其它颜色，常见的有金、银、黑、白、灰。
感光膜	颜色	蓝	感光膜，也称菲林膜，菲林纸。是以塑料透明薄膜为片基，在其上涂布一定厚度的感光乳剂而制成的。主要用于间接法和直间法制版，其产品颜色一般有红、蓝、绿三种。
圣诞色	颜色	红	圣诞色是西方人和家家户户欢度圣诞节时要用的装饰颜色，以红、绿、白三色为主色调。
环天顶弧	颜色	紫	环天顶弧(circumzenithalarc)的现象为在天空中形成如倒挂的彩虹一般的七色圆弧。其颜色顺序自下而上分别为：红、橙、黄、绿、蓝、靛、紫。
泥质岩	颜色	黄	泥质岩argillaceousrocks包括泥岩、粘土岩、页岩、板岩等。因形成条件不同，有白、灰白、灰、黄、绿、红褐、棕等各种颜色。
男士胸罩	颜色	黑	男士胸罩是日本一家厂商推出的专门为男人们设计胸罩，这种男士胸罩有黑、白、粉红三种颜色。
陀螺果	种	陀螺果	陀螺果（MelliodendronxylocarpumHand.-Mazz.），又名水冬瓜、冬瓜木、鸦头梨等，是安息香科陀螺果属植物，也是陀螺果属的属模式种。
岩色跃蛛	种	岩色跃蛛	岩色跃蛛，Sitticussaxicola(C.L.Koch)，跳蛛科跃蛛属的一个物种。
黄花冷水花	种	黄花冷水花	黄花冷水花（学名：PilealongicaulisHand.-Mazz.var.flavifloraC.J.Chen）为荨麻科冷水花属下的一个变种。
秋茄	种	秋茄树	秋茄，即秋茄树，Kandeliacandel(Linn.)Druce，红树科秋茄树属植物，红树林的常见品种，果实形状似笔，成熟后跟茄子非常相似。
黑藜芦	种	黑藜芦	黑藜芦（学名：Veratrumnigrum）为百合科藜芦属下的一个种。
瑰丽七夕鱼	种	瑰丽七夕鱼	瑰丽七夕鱼，即丽鮗（学名：Calloplesiopsaltivelis），又称瑰丽鮗、瑰丽七夕鱼、近美七夕鱼、孔雀七夕鱼、海水斗鱼，为辐鳍鱼纲鲈形目七夕鱼科丽鮗属的其中一个种。
白线鲈	种	白线鲈	白线鲈，Anyperodonleucogrammicus，属于辐鳍鱼纲鲈形目鲈亚目鮨科光腭鲈属的其中一个种，也叫白线光颚鲈、白线光颌鮨、白线鮨。
波缘凤仙花	种	波缘凤仙花	波缘凤仙花（学名：Impatiensundulata）为凤仙花科凤仙花属下的一个种。
臭红菇	种	臭红菇	臭红菇又名臭黄菇，是担子菌纲伞菌目红菇科的一种真菌类生物。
大叶蛇总管	种	显脉香茶菜	大叶蛇总管，是一种植物药材，取自唇形科植物显脉香茶菜的全草，主治急性传染性肝炎，疮毒湿疹，皮肤瘙痒。
宽翅闪花蝇	种	宽翅闪花蝇	宽翅闪花蝇，Acrostilpnalatipennis(Zetterstedt，1838)，花蝇科闪花蝇属的一个物种。
黑麦嵩草	种	黑麦嵩草	黑麦嵩草（学名：Kobresialoliacea）为莎草科嵩草属下的一个种。
长翅鹞	种	长翅鹞	长翅鹞，Circusbuffoni（Gmelin,1788），脊索动物门、鸟纲、隼形目、鹰科、鹞亚科、鹞属的一个物种。
薄叶双盖蕨	种	薄叶双盖蕨	薄叶双盖蕨为属蹄盖蕨科双盖蕨属下植物其分布于我国浙江、福建、江西、湖南、广西、贵州、四川和云南等省区，日本也有分布，为东亚分布的种类。
缨腹泉蝇	种	缨腹泉蝇	缨腹泉蝇，Pegomyacrinisternita（Fan,FanQ.S.etMaS.Y.），花蝇科泉蝇属的一个物种。
美丽水绵	种	美丽水绵	美丽水绵（学名：SpirogyravenustaJao）是双星藻科、水绵属下的一个植物种。
塔圆腹蛛	种	塔圆腹蛛	塔圆腹蛛，Dipoenaturriceps(Schenkel，1936)，球蛛科,圆腹蛛属的一个物种。
维氏双边鱼	种	维氏双边鱼	维氏双边鱼，Ambassisvachellii，双边鱼科双边鱼属的一个物种。
噪鸥属	种	即鸥嘴噪鸥	噪鸥属鸟纲燕鸥科动物本属仅1种即鸥嘴噪鸥Gelochelidonnilotica。
珍珠丽七夕鱼	种	珍珠丽七夕鱼	珍珠丽七夕鱼，Calloplesiopsaltivelis，七夕鱼科丽鮗属的一个物种。
丽江马先蒿丽江亚种	种	丽江马先蒿丽江亚种	丽江马先蒿丽江亚种（拉丁学名：PedicularislikiangensisFranch.subsp.likiangensis）是玄参科，马先蒿属多年生草本植物，高可达18厘米，无主根，茎在当年的植株中多单条，节上毛尤多而长。
竹都玄灰蝶	种	竹都玄灰蝶	竹都玄灰蝶，TongeiazuthusLeech，灰蝶科玄灰蝶属的一个种。
网纹石斑鱼	种	网纹石斑鱼	网纹石斑鱼，Epinephelusmerra，又称蜂巢石斑鱼。是鮨科石斑鱼属的一个物种。
天胡荽金腰	种	天胡荽金腰	天胡荽金腰，虎耳草科、金腰属的一种植物，多年生草本，高约27厘米。
细灰蝶	种	细灰蝶	细灰蝶Leptotesplinius(Fabricius,1793)，灰蝶科细灰蝶属的一个物种。
盾翅藤	种	盾翅藤	盾翅藤（学名：Aspidopterysglabriuscula），为金虎尾科盾翅藤属下的一个植物种。
木里赤瓟	种	木里赤瓟	木里赤瓟（学名：Thladianthalijiangensisvar.latisepala）为葫芦科赤瓟属下的一个变种。
红腿雀鹰	种	红腿雀鹰	红腿雀鹰，Accipitererythropus（Hartlaub,1855），脊索动物门、鸟纲、隼形目、鹰科、鹰亚科、鹰属的一个物种。
西安棘蝇	种	西安棘蝇	西安棘蝇，Phaoniaxianensis（XueetCao，1989），蝇科棘蝇属的一个物种。
双珠大绢蝶	种	双珠大绢蝶	双珠大绢蝶，ParnassiusimperatorOberthur，绢蝶科绢蝶属的一个物种。
勐仑银斑蛛	种	勐仑银斑蛛	勐仑银斑蛛，Argyrodesmenlunensis（ZhuetSong，1991），球蛛科银斑蛛属的一个物种，分布于云南。
珠履带蛱蝶	种	珠履带蛱蝶	珠履带蛱蝶，AthymaasuraMoore，蛱蝶科带蛱蝶属的一个物种。
锐片毛蕨	种	锐片毛蕨	锐片毛蕨是金星蕨科的一个物种，特产于云南东南部。
连萼谷精草	种	连萼谷精草	连萼谷精草（学名：EriocaulonbuergerianumKoern）是谷精草科、谷精草属下的一个物种，属于丛生类植物。
毛笋泉蝇	种	毛笋泉蝇	毛笋泉蝇，Pegomyaphyllostachys（Fan，1964），花蝇科泉蝇属的一个物种。
双斑黑尺蛾	种	双斑黑尺蛾	双斑黑尺蛾，Abaciscuscostimacula(Warren,1912)，尺蛾科的一个物种。
花豹盛蛱蝶	种	花豹盛蛱蝶	花豹盛蛱蝶（姬黄三线蝶）Symbrenthiahypselis(Godart,)，鳞翅目蛱蝶科盛蛱蝶属的一个物种。
新西兰蛎鹬	种	新西兰蛎鹬	新西兰蛎鹬，Haematopusunicolor（Forster,1844），是蛎鹬科蛎鹬属一种中型涉禽。
红带花鮨	种	红带花鮨	红带花鮨，Pseudanthiasrubrizonatus，鮨科花鮨属的一个物种。
黄风藤	种	毛玉叶金花	黄风藤是一种中草药。药材基源为双子叶植物药茜草科植物毛玉叶金花的茎叶。
射毛悬竹	种	射毛悬竹	射毛悬竹（学名：Ampelocalamusactinotrichus）为禾本科悬竹属下的一个种。
岷江金丝梅	种	岷江金丝梅	岷江金丝梅（学名：Hypericumhenryisp.uraloides）为藤黄科金丝桃属下的一个亚种。
宽带樗蚕	种	眉纹天蚕蛾	宽带樗蚕，Samiacynthiacanningi(Hutton，1860)，是大蚕蛾科樗蚕蛾属眉纹天蚕蛾的一个亚种。
石棉南星	种	石棉南星	石棉南星，是天南星科天南星属的一种植物。
内斑小舟蛾	种	内斑小舟蛾	内斑小舟蛾，Micromelalophadorsimacula（Kiriakoff，1963），舟蛾科小舟蛾属的一个物种。
高山豆属	种	高山豆属	高山豆属，豆蝶形花科，多年生草本，植株呈莲座状，下分4种，生于海拔2000米以上的高山林缘或灌丛草地，分布于我国甘肃、四川、云南及西藏。
小斑螟	种	小斑螟	小斑螟，Aglossacaprealis，斑蛾科的一个物种。
粉头皇鸠	种	粉头皇鸠	粉头皇鸠，拉丁名叫Ducularosacea，鸽形目鸠鸽科皇鸠属的一个物种。
长蔓通泉草	种	长蔓通泉草	长蔓通泉草（学名：Mazuslongipes），为玄参科通泉草属下的一个植物种。
西藏点地梅	种	西藏点地梅	西藏点地梅（学名：Androsacemariae）为报春花科点地梅属下的一个种。
剡纸	特点	白	由于其白和韧的特点，剡纸不但是书写上品还可用来制帐、制被。
剡纸	特点	薄	剡纸的主要特色是薄、韧、白、滑，因而也被称为“玉叶纸”。由于其白和韧的特点，剡纸不但是书写上品还可用来制帐、制被。
双零楼	特点	透	如果用十个字来概括“双零楼”的综合特点的话，那就是：高，大，宽，通，透，亮，多，绿，湿，美。
双炊糕	特点	香	双炊糕是浙江瑞安汉族糕点，由名师李瑞庆创制于清代光绪年间，距今已有100多年的历史。它用糯米粉加白糖或红糖拌匀过筛，撒上桂花，成型切块，经两番炊制而成。其特点是：细、软、韧、香、甜、老少皆宜，是温州市名牌菜食。
八集小花生	特点	脆	八集小花生是泗阳名特产之一，有着悠久的历史和浓郁的地方特色。因产于江苏省泗阳县八集乡，而得名。花生壳薄，肉嫩，口感好，富含钙、铁、镁、锌等微量元素，含油量高达40%-43%。经过炒制，具有白、香、甜、脆的特点。
合伯宝剑	特点	强	当代的合伯宝剑承袭了古代手工千锤百炼、金属改性的传统工艺，具备“强、韧、硬、弹”四大特点，硬可斩钉截铁，韧可弯曲120度不断裂变形，光鉴寒霜，灵气逼人。
捞汁	特点	酸	捞汁是一款由酿造酱油、果汁、酿造食醋及各种香辛料调和而成的复合调味汁；捞汁的口味特点是：酸、甜、鲜、咸、微辣；捞汁菜品是一款凉拌菜的升级与创新产品，少放汁即为拌菜，多放汁即为捞菜；捞汁菜以无油、低盐、多醋、多素，满足了广大老百姓对健康饮食的需求。
岐山面	特点	筋	它的特点是：面条细长，厚薄均匀，臊子鲜香，红油浮面，汤味酸辣，筋韧爽口，老幼皆宜。岐山面在关中地区有其非常重要的地位，在婚丧、逢年过节、孩子满月、老人过寿、迎接亲朋等重要场合都离不开。
岐山面	特点	光	岐山面以薄、筋、光、煎、稀、汪、酸、辣、香而著名。它的特点是：面条细长，厚薄均匀，臊子鲜香，红油浮面，汤味酸辣，筋韧爽口，老幼皆宜。岐山面在关中地区有其非常重要的地位，在婚丧、逢年过节、孩子满月、老人过寿、迎接亲朋等重要场合都离不开。
小孩酥糖	特点	香	小孩酥糖,又名小儿酥、小儿酥糖、小孩酥，是徐州汉族传统名点，起源于清朝乾隆年间，其特点是“香、酥、甜”三性具备，是老少皆宜之佳品。
宁式苔生片	特点	脆	宁式苔生片是浙江宁波汉族糕点代表品种之一。宁式片糕有几百年生产历史。不少片糕生产季节较强，而苔生片却可长年生产，产品具有香、松、脆和苔菜咸鲜味等特点，深受群众欢迎。
感王韭菜	特点	长	感王韭菜的特点是长、宽、白、绿、嫩、脆、味鲜。
围纱	特点	薄	围纱，服饰的一种，轻盈、薄、软、透明是其特点。
红西凤	特点	辣	红西凤产于陕西省宝鸡市凤翔县柳林镇，西凤酒是以大麦、豌豆制成，优质高粱为原料，配以凤凰泉泉水，贮存三年，再经勾兑而成。具有集清香、浓香于一体，酸、甜、苦、辣、香五味俱全的特点。
秸秆	特点	钾	农作物光合作用的产物有一半以上存在于秸秆中，秸秆富含氮、磷、钾、钙、镁和有机质等，是一种具有多用途的可再生的生物资源，秸秆也是一种粗饲料。特点是粗纤维含量高（30%-40%），并含有木质素等。
简报	特点	实	也可以说，简报就是简要的调查报告，简要的情况报告，简要的工作报告，简要的消息报道等。它具有简、精、快、新、实、活和连续性等特点。
碎米鸡丁	特点	滑	具有地方特色，基本特点是咸并微甜，带有酸辣味，脆嫩适口。碎米鸡丁将细碎的鸡丁、花生碎、以及葱花、泡椒碎末混合在一起，入口感觉香、脆、滑、嫩、鲜，实在是配米饭的好菜。
桂花高	特点	糯	其名取自“桂花高下一般香”的诗句。 口感具有香、软、糯三大特点，滋味浓郁，回韵悠长加上“无加匪物”的高端品质，颇受消费者的喜爱。
花仙峡	特点	奇	花仙峡集自然山水之幽、秀、险、奇等特点于一体，一直鲜为人知，无人涉足，与小山峡、大宁河等旅游区相比，有过之而无不及，是极具开发价值的旅游处女地。
闯王刀	特点	快	闯王刀以技击实践为中心，编排套路结构严紧，布局匀称，运动清晰，招术奇特，手法惊异，步法多变，美无花架，实而不华，马上步下均适用。攻如猛虎下山，具迅雷不及掩耳之势，防时稳如泰山，伺机相还。临阵应用，以攻为主，先发制人。其特点是猛、快、巧、准。
麻筒	特点	酥	“蓼花”与“麻筒”均具有营养丰富、酥脆可口的特点。
麻筒	特点	香	仙游县生产麻筒历史悠久，是福建具有松、香、酥、脆、清甜的独特风味的名点。以糯米、蔗糖、纯碱、麦芽糖为原料，经制作成冬瓜样的白果条后，油炸为蓼花胚。如沾满蓼花米即成“蓼花”，若沾满炒芝麻，由成为“麻筒”。“蓼花”与“麻筒”均具有营养丰富、酥脆可口的特点。
醋溜油条	特点	甜	家里剩下的油条，不吃可惜，加热一下口感又不好，所以今天做一道如何使剩下的油条既美味又达到不浪费的菜肴—醋溜油条，其特点是：酸、甜、酥、脆。
咖喱素鸡块	工艺	炒	咖喱素鸡块是一道美食，原料工艺：炒口味：咖喱味。
亵衣	工艺	贴	古代女子的内衣最早被称为“亵衣”。过腰、胸、肩等分别系带，是为了在流动中达到不同的‘塑身修形’效果。袋口的拼接处，必须绣上小幅图案来遮住线的结点，保持画面完整，这便是所谓‘触景生情’”，且汇聚了绣、缝、贴、补、缀、盘、滚等几十种工艺，用以表达不同的主题。
八宝脱骨鸡	工艺	炖	八宝脱骨鸡是一道美食，主要原料是鸡，口味是咸鲜味，工艺是炖，营养丰富，味道可口。
冰糖花生猪脚	工艺	煮	冰糖花生猪脚的做法详细介绍菜系及功效：家常菜谱补血食谱补虚养身食谱口味：甜味工艺：煮。
冬阴功汤面	工艺	煮	冬阴功汤面属于东南亚菜，主要原料是面条、虾肉、蘑菇，口味是酸辣，工艺是煮，难度属于中级。
五香烤鱼	工艺	腌	五香烤鱼是烤鱼中的一种，与以往人们熟悉的烧烤制品有所不同，它融合了腌、烤、炖等多种工艺技术，先烤后炖，既传承了烧烤工艺又结合了火锅用料的特点，口味鲜香，营养丰富。
南瓜糯米饼	工艺	煎	南瓜糯米饼属于点心菜谱，主要原料是南瓜、糯米粉；工艺是煎，制作简单！。
公婆饼	工艺	烤	公婆饼是恩施地区十大名小吃之一，因其突出的民族风味和特殊的制作工艺深受人们的喜爱。主要食材是面粉，主要烹饪工艺是烤。
剁椒蚕豆春笋	工艺	炒	剁椒蚕豆春笋素食，主要原料是蚕豆，春笋，口味是微辣，工艺是炒，难度属于中级。
印度式烟鲳鱼	工艺	烤	印度式烟鲳鱼属于印度菜，主要原料是鲳鱼，口味是鲜香，工艺是烤，难度属于高级。
五彩龙利鱼丁	工艺	炒	五彩龙利鱼丁属于家常菜谱，主要原料是火龙果、青椒/甜椒、胡萝卜，口味是鲜香，工艺是炒，难度属于中级。
冰镇盐津滑鸡	工艺	腌	冰镇盐津滑鸡由盐腌鸡，麻油、鸡粉调调料，按照一定的炒作工艺制作的菜肴。
台式香辣红烧牛肉面	工艺	煮	台式香辣红烧牛肉面属于精品主食，主要原料是面条、牛腩，口味是辣，工艺是煮，难度属于中级，希望您按此菜谱制作！。
三丝白菜卷	工艺	拌	三丝白菜卷是以大白菜（白梗）为主料，辅以胡萝卜、香菇、青椒，加入白砂糖、香油、花椒、姜等调料后，以拌为主要工艺，做成的一道私家菜，有健脾开胃调节便秘的功效。
大黄鸭饭	工艺	炒	大黄鸭饭属于宝宝/儿童，主要原料是大米、南瓜、西葫芦，口味是香，工艺是炒，难度属于中级。
海蟹萝卜汤	工艺	煮	海蟹萝卜汤属于羹/汤，主要原料是螃蟹、白萝卜，口味是鲜，工艺是煮，难度属于中级。
肉末菜粥	工艺	煮	肉末菜粥属于粥/稀饭，主要原料是大米，口味是香，工艺是煮，难度属于中级。
虫草花木瓜排骨汤	工艺	煮	虫草花木瓜排骨汤属于羹/汤，主要原料是排骨、木瓜，口味是鲜，工艺是煮，难度属于中级。
面线鱼	工艺	煮	面线鱼是一道美味可口的汉族传统佳肴，属于家常菜谱，主要原料是桂鱼、乌冬面、油菜，口味是香，工艺是煮。
鲜肉香芋盒	工艺	炸	鲜肉香芋盒是一道美食，主要原料是荔浦芋、肥瘦猪肉、开洋，口味是香脆，工艺是炒、炸。
吉祥兽	中国	龙	中国四大吉祥兽为：龙、凤、龟、麒麟。吉祥兽的表现形式多种多样，其中以书画、雕刻为主。四大吉祥兽中，除龟外其他三种都为人民所虚化出来的形象，因此从造型上来说各个地方各个时代会有差别。
味噌鱼排	质	嫩	味噌鱼排是一道日本料理，是选用雕鱼柳为主料，用味噌腌制入味后，再用油炸至金黄色而成。雕鱼柳刺少质嫩，味道鲜美，很适合怕鱼刺者常食。
不锈钢筛管	应用	气	不锈钢筛管又称为滤水管，被广泛用于油，气，水井防砂工业中，尤其在水井工业中地位突出，在水资源过滤筛管中应用广泛。不锈钢筛管采用全绕焊生产工艺，应用特制梯形丝绕组在呈圆周式排列的一组支撑丝上焊制而成。
三丁煎排骨	口感	嫩	三丁煎排骨，一道川香味家常菜，肉质嫩、鲜、脆、香的口感，百吃不厌。
白灼章鱼	口感	脆	白灼章鱼吃的是原味，上等白灼章鱼材料必须新鲜生猛，冷冻海鲜不适合这个做法。口感讲究嫩，脆，爽，不能过火。
汤团缸鸭狗	口感	甜	汤团缸鸭狗是浙江省汉族名小吃。口感软、糯、甜、香。
三代红	红	农	“三代红”是指三代都是工、农、兵、革命干部，所谓根正苗红。但凡贴上“三代红”标签的一族，就很高调地从周围同龄一代中分离出来，并且在招工培训上调入学参军甚至出国，都享有优先权，也可以称为“红色贵族”。
五姓财神	身色	白	五姓财神，梵名为瞻巴拉、阎婆罗、雾神，旧译布禄金刚。这五财神的身色，分别是绿、白、红、黄、黑财神。
公开调解	涉及	广	公开调解是指人民调解委员会在调解纠纷时，向当地群众公布调解时间、调解场所，邀请当事人亲属或朋友参加，允许群众旁听的调解方式。这种调解形式主要适用于那些涉及面广、影响大、当事人一方或双方有严重过错，并对群众有教育示范作用的纠纷。
上蔡县宁庄清真寺	主要姓氏	白	上蔡县宁庄清真寺，坐落在上蔡县朱里乡宁庄村村西南角。坊上有回民230人，主要居住在宁庄村。回民的主要姓氏有：白、杨、陈等姓氏。
庞清水村	主要姓氏	刘	庞清水村位于宋道口镇政府偏南0.5公里处。有273户，1012口人。主要姓氏有庞、刘、张。
曹家响堂	主要姓氏	甘	曹家响堂：湖北襄阳市樊西区王寨乡乔营村一组。人口约500人，主要姓氏为张、曹、李、甘等。
犁市村	主要姓氏	梁	犁市村位于广东省韶关市浈江区犁市镇中心，由5个自然村组成，主要姓氏有侯、李、钟、梁、叶、吴等·。
杜土村	主要姓氏	韩	杜土村位于宋道口镇政府西偏北2.5公里处。有430户，1611口人。主要姓氏有杜、赵、李、蔡、韩。
佳力	嫁接亲和力	强	佳力-砧木种子，耐低温，嫁接亲和力强，共生亲和力好；适于嫁接黄瓜、甜瓜；高抗枯萎病，对黄瓜、甜瓜品质无不良影响。
南汇皮影戏	常用乐器	笙	南汇皮影戏唱腔颇有特色，一般用浦东高腔和浦西平调。曲调有十五、六种，风格独特，有“噫腔”、“啊腔”、“嗨腔”、“哼腔”、“姆妈腔”、“叽改腔”等。皮影戏乐队常用乐器有二胡、笛、笙、三弦、唢呐，以及小堂鼓、小锣等。
五联整合疗法	机理	清	五联整合疗法是秉承祖国医学：清、消、散、调、补五大机理，结现代医学诊疗技术，彻底治愈乳腺病。
交通气象指数	根据	雾	交通气象指数是根据雨、雪、雾、沙尘、阴晴等天气现象对交通状况的影响进行分类，其中主要以能见度为标准，并包括对路面状况的描述。
乌玉块	气味	湿	释名：亦名乌金、陈玄、玄香、乌玉块。气味：辛、湿、无毒。
土朱	气味	寒	土朱释名代赭石，亦名须丸、血师、铁朱。气味苦、寒、无毒。
方茎	气味	甘	方茎释名：巨胜、狗虱、油麻、脂麻。叶名青蓑，茎名麻皆。气味：甘、平、无毒。
桧柽柳	气味	咸	桧柽柳是一种可供观赏，可药用的一种柳树，是柽柳科(Tamaricaceae)柽柳属(Tamarix)，有多个别称，气味甘、咸、温、无毒。
羌青	气味	甘	羌青释名：亦名羌活、羌青、独摇草、护羌使者、胡王使者、长生草。李明珍说：“独活、羌活乃一类二种，以中国者为独活；气味：苦、甘、平、无毒。
槐实	气味	苦	槐实，亦称槐角气味苦、寒、无毒。槐实即槐角，为豆科落叶乔木槐树的成熟果实。
花荞	气味	平	释名：翘、乌麦、花荞，气味：甘、平、寒、无毒。
薇草	气味	苦	亦名薇草、白幕、春草、骨美、。气味（根）苦、咸、平、无毒。
蜀漆	气味	平	蜀漆又名鸡尿草、鸭尿草、七叶，功效除痰；截疟，主治症瘕积聚，疟疾，气味辛、平、有毒。
鰟魮	气味	辛	鰟魮可用于以下「中药偏方」：威灵仙和乌药(急性腰部扭挫伤)释名：旁其、矮樟、乌药。气味：（根）辛、温、无毒。
黄桔鹃	气味	寒	黄桔鹃释名：天仙子、闹羊花、黄桔鹃、羊踯躅、横唐、行唐。气味：（子）苦、寒、无毒。
铁朱	气味	寒	释名代赭石，亦名须丸、血师、土朱、铁朱。气味苦、寒、无毒。
赤箭芝	气味	温	赤箭芝的根为天麻，药用部分指此。气味辛、温、无毒。
九羊启泰	图案	梅	九羊启泰是汉族传统吉祥图案，以九只羊为主图。另有松、竹、梅等辅图。
上班病	现象	庸	“上班病”就是当前各单位上班的工作人员在上班时具有庸、懒、散、软等现象。
五姓七望	五姓	王	即陇西李氏（今甘肃省东南部）、赵郡李氏（今河北赵县）、博陵崔氏（今河北安平县、深县、饶阳、安国等地）、清河崔氏（今河北清河县）、范阳卢氏（今保定市和北京市一带）、荥阳郑氏（今河南省）、太原王氏。其中李氏与崔氏各有两个郡望。所以称之为五姓七望，或五姓七家。
五姓七望	五姓	李	其中李氏与崔氏各有两个郡望。所以称之为五姓七望，或五姓七家。
五彩线	颜色组成	黄	五彩线，由红、黄、兰、绿、紫等五个颜色组成。古代也叫五彩长命缕。系五彩线也就成了端午节不可缺少的部分。
五灵仙术	五灵	风	五灵仙术为仙剑奇侠传中很重要的一个部分，目前在仙剑奇侠传三及其外传问情篇中最为突出。其中五灵指的就是风、雷、水、火、土，五灵之说起于女娲补天，伏裔造人之时。
十紧要	十项要求	穴	十紧要是汉族风水学术语。风水九歌十诀之一，是中国古代风水家关于龙、穴、砂、水的十项要求。
利川山药	微量元素	硒	利川山药，在利川市有1500多年的种植历史，地道的山珍佳肴，是来自山野的“绿色之风”，富含硒、锗等稀有微量元素，性平味甘、无副作用，是医疗上一种常用中药。
彩色小麦	微量元素	碘	根据农业部农产品质量监督检验测试中心检测：彩色小麦除含有丰富的蛋白质和赖氨酸外，还含有锌、硒、钙、铁、碘等多种对人体有益的微量元素和矿物质。
热水塘温泉	微量元素	氧	热水塘温泉为地热水温泉，至今开发利用400多年，水中含人体所需或对疾病有疗效的氧、氟、硅、镭等47种化学微量元素，水温在83摄氏度左右，对各种皮肤病、风湿病、高血压和心血管等病症有特殊疗效。
南来顺	烹饪特色	涮	南来顺饭庄是有着近70年历史的京华老字号，以爆、烤、涮等烹饪特色闻名京城，其小吃宴更是精美绝伦，独领风骚。
世界福	五福	财	在人间最美好的福愿里向来有五福（福、禄、寿、喜、财）临门的说法，“世界福”将中华传统的“五福”巧妙地融入设计中，并涵括了“世界福”的九个福愿，堪称“至尊之福”，寓意“世界福”即将成为“世界共同幸福”的至尊符号。
八步区人民法院	地处	湘	八步区人民法院位于广西贺州市区，地处桂、湘、粤三省（区）交界地带，其前身为贺县人民法院，成立于1951年8月，1997年设县级贺州市后更名为贺州市人民法院。
冷藏食品	广泛用于	肉	冷藏食品分为冷却食品和冻结食品，冷藏食品易保藏，广泛用于肉、禽、水产、乳、蛋、蔬菜和水果等易腐食品的生产、运输和贮藏；营养、方便、卫生、经济；市场需求量大，在发达国家占有重要的地位，在发展中国家发展迅速。
中华人民共和国预备役军官退役荣誉章	授予	金	解放军总政治部日前印发《关于启用中华人民共和国预备役军官退役荣誉章》的通知，明确从2013年1月1日起，为符合预备役军官法正常退役的预备役军官，按照服役时间和贡献，分别授予金、银、铜质荣誉章。
呼伦贝尔客运东站	通达	吉	呼伦贝尔客运东站位于海拉尔区风情园路东侧，呼伦贝尔客运东站建成后，将担负起全市13个旗市区和来呼伦贝尔旅游的客流、物流的集散任务，通达黑、吉、辽、京，辐射内蒙古东部和西部。
双鸟朝阳纹象牙碟形器	藏品类别	骨	双鸟朝阳纹象牙碟形器是浙江省博物馆藏，于1977年在河姆渡遗址出土，藏品类别为骨、角、牙器。
农三师四十三团	资源	热	农三师四十三团地处塔克拉玛干大沙漠西南缘的麦盖提县境内，水、土、光、热资源开发利用的潜力很大。
内河航道	内陆水域	湖	内陆水域包括江、河、湖、水库、人工运河和渠道等。内河航道可分为天然航道和人工航道。
动物奇观五	主要图案	猪	动物奇观五为老虎机其中之一种主题游戏，主要图案为乌龟、猪、狗、鸟等动物构成的游戏画面，有趣并好玩。
包装商品	形态	坛	按照商品包装的形式和材料，通常可以分为箱装配送商品、桶装配送商品、袋装配送商品、捆装配送商品和其他坛、罐、瓶状、卷筒状、编筐状等多种形态的包装商品。
东西境老街	格局	田	东西境老街位于广东省增城市小楼镇东、西境村，东西境老街是周姓家族几百年来生产生活和繁衍生息的聚居地。老街极具富岭南特色的“田、塘、村、林”古村落格局。
东阿香山遗址	出土器物	鬲	东阿香山遗址为台形高地，面积8800平方米。表面为灰土层，陶片遍地，出土器物有鬲、罐、顶等，以灰陶居多，也有黑陶与红陶，以大汶口、龙山文化遗物为主。
北京条约	签订	清	《北京条约》是1860年英法联军攻进北京后，英、法、俄强迫清政府分别签订的结束第二次鸦片战争的不平等条约。
医经读	四集	平	《医经读》是清代沈又彭编写的一部书籍，分“平、病、诊、治”四集。
古代诗歌	古代诗歌包括	词	古代诗歌包括诗、词、曲，但古代诗歌的体裁却不外乎古体诗和近体诗两大类。
利什曼原虫病	易感动物	犬	利什曼原虫病是由利什曼属的各种原虫所致人兽共患的一种以慢性经过为主的寄生虫疾病。本病临诊病理特征为不规则高热、消瘦、贫血、白细胞减少，肝、脾、淋巴结肿大，在皮肤和黏膜形成肥厚或溃疡病变。其易感动物有犬、猫、牛、马、绵羊等，试验动物鼠、海豚和猴等也均易感。
原始佛教	三学	定	后人把原始佛教的修持，概括为戒、定、慧三学、慈悲喜舍四无量心以及四念处、四正断、四神足、五根、五力、七觉支等三十七菩提分法。
兰芳绣庄	风格	精	邢兰芳，师从苏绣大师高文娟，2004年，牵头成立了兰芳绣庄，集培训、制作、销售于一体，其苏绣作品山水能分远近之趣，楼阁具现深邃之体，人物具有瞻眺生动之情，花鸟能报绰约亲昵之态，具有“精、细、雅、洁”独特的艺术风格。
内画	流派	京	内画艺术分为京、冀、鲁、粤四大流派，其中尤以冀派内画水平最高、规模最大、发展最快、影响最大，不久前已入选国家非物质文化遗产保护名录，冀派内画的发源地——河北衡水，还被文化部命名为“中国内画之乡”。
三途对三毒	三毒	贪	三途对三毒出自《佛学大词典》，即火、刀、血三途配嗔、贪、痴三毒。
佛教三毒	三毒	嗔	佛教三毒，指世间众生所染三种根本毒害，即贪、嗔、痴。道教受佛教义理影响，认为世间众生之所以沦入苦海。受诸烦恼，不得解脱，皆因后天习染三毒所致。
体腔	器官	肝	人的体腔由膈肌分成上下两个部分，上面的叫胸腔，里面有心脏和肺等器官；下面的叫腹腔，内有胃、肠、肝、胆囊、脾和肾等器官。
剑术	击法	崩	剑的击法有；劈、刺、点；撩、崩、截、抹、穿、挑、提、绞、扫等。剑术的特点是：轻快敏捷、潇洒、飘逸，有"剑走美式"、"剑如飞风"之说。
加料海参	添加	胶	加料海参是指那些添加了糖、盐、胶、甚至火碱的海参，一些不法商人为了谋取暴利，制作加料海参冒充淡干海参，欺骗消费者的同时也损害消费者的健康。
可信任系统	安全级别	D	可信任系统是美国国防部定义的安全操作系统标准，该标准共分为A、B、C、D四个大的安全级别。
仪仗队	组成	海	仪仗队是军队中执行礼仪任务的分队，由陆、海、空三军人员共同组成或由某一军种人员单独组成，执行任务时，配有军乐队，象征着国家或军队的最高礼仪。
少林燕青刀	组成	斩	少林燕青刀是少林传统武术中的优秀套路之一，属于短器械的一种，因刀术在实战中有重要的作用，历代少林寺僧很注重刀术的练习，该刀法主要以劈、撩、刺、斩、崩、按、推、架、缠头、裹脑、舞花等刀法组成。
大木作	组成	柱	大木作，古代汉族木构架建筑的主要结构部分，由柱、梁、枋、檩等组成。同时又是木建筑比例尺度和形体外观的重要决定因素，大木是指木构架建筑的承重部分。清式大木作做法可分为大木大作和大木小作式两类。
双椒炒牛柳	配料	蒜	双椒炒牛柳是一道家常炒菜，主料有牛柳、杭椒、青椒，配料有葱、姜、蒜、红干辣椒等、其特点是制作简单、味道香辣浓厚、牛肉滑嫩，双椒爽口，适合各类人群食用。
紫薯苦瓜盅	配料	糖	紫薯苦瓜盅是一道美食，主要原料有苦瓜。配料有紫薯、糖、盐。
肉片炒快餐面	配料	盐	肉片炒快餐面。主料3包快餐面150g瘦猪肉100g青菜配料适量油适量盐适量生粉适量鸡精适量生抽。
俄罗斯加入巴黎俱乐部	主要成员	法	俄罗斯加入巴黎俱乐部是在1997年6月20日1997年6月20日俄罗斯总统叶利钦宣布俄已原则上被接纳为巴黎俱乐部成员据俄罗斯方面宣布俄于20日就俄加入巴黎俱乐部问题同该俱乐部达成了原则协议巴黎俱乐部成立于1961年其主要成员为美英法德等西方国家。
六欲	注释	口	东汉哲人高诱对此作了注释：“六欲，生、死、耳、目、口、鼻也。”可见六欲是泛指人与生俱来的生理需求或欲望。
卢范大庄墓群	时期	周	卢范大庄墓群：商、周、春秋、战国时期的墓葬群，位于柳沟乡卢范大庄村南100米处一无名山丘前坡。
制香附	味	辛	制香附，一种中药，味辛、微苦、甘，性平。
生首乌	味	涩	首乌其性微温，味苦、甘、涩。生首乌，就是刨出来直接晒干了，跟那生晒参差不多，制首乌，就是把首乌弄完了以后削成片，然后搁咱们说那黑豆，搁黑豆掺在一蒸，而且是久蒸久晒，蒸完了以后再晒干，晒干以后再蒸，蒸完以后再晒干，久蒸久晒以后才叫制首乌。
刘文阁	手术原则	细	刘文阁，博士研究生（北京协和医科大学医学美容整形专业），职业格言：“科学严谨，精益求精，以人为本”。手术原则“稳、准、轻、慢、细、巧”。
六案	机构	吏	六案liùànㄌㄧㄨˋㄢˋ宋于州、县仿吏、户、礼、兵、刑、工六部设六个办事机构，称“六案”。
化忌	四恶	戾	为化禄、化权、化科、化忌“四化”之一。根据《归藏易》属木蛊羽阵和鸠烛阵。位置在西方玄武星宿的毕宿，是属于大吉星，根据《归藏易》记载遇到幽、戾、哀、靖“四恶”时，反吉为大凶。
八端	精髓	信	八端是指：孝、悌、忠、信、礼、义、廉、耻。这是孔子他老人家的德育内容的全部精髓。
呆小路	属性	草	名称：呆小路序号：748属性：草身高：1.6m体重：5.6kg颜色：蓝爱好：喜欢晒太阳简介：看我样子很酷，其实我也没有什么特别，装酷的秘诀就在于你要勇敢的在头上顶一块破抹布。
低碳钢丝	元素	铜	低碳钢丝又名铁丝，低碳钢丝是用低碳钢拉制成的一种金属丝，铁丝按用途不同，成分也不一样，它含有的成分有：铁，钴，镍，铜，碳，锌，还有其他元素。
东灶港	盛产	蟹	东灶港，位于海门市的东北部，她北枕黄海，东邻吕四渔港，盛产各种的鱼、虾、蟹、贝。全港注册捕船553艘，22个码头连成一体，形成一个大规模的水产交易市场。东灶港交通便捷，商贾云集，是一个繁荣文明的群众渔港。
北董屯	盛产	桃	北董屯位于辽宁省瓦房店市赵屯乡境内，属山地地形，盛产红富士苹果、桃、梨、李、杏、等水果，环境优美。
东白堌	盛产	杏	东白堌行政村位于山东省临清市尚店镇西南部，距镇政府4公里，是远近文明的水果之乡，盛产苹果，梨，桃，杏等。
压花	材料	根	压花源于英文的pressedflower，直接翻译“压花”。将植物材料包括根、茎、叶、花、果、树皮等经脱水、保色、压制和干燥处理而成平面花材，经过巧妙构思，制作成一幅幅精美的装饰画、卡片和生活日用品等植物制品，融合植物学与环保学于一体的艺术。
小农具	材料	木	由竹、木、荆柳、钢铁等材料制成。中国小农具的品种、规格多样，包括用于耕整地、种植、施肥、中耕、灌溉、收获、脱粒、清选、加工、运输、园林管理等项作业的各类小农具，每类小农具又有许多规格品种。
执手锁	材料	铝	执手锁拉手的材料有锌合金、铜、铝、不锈钢、塑胶、原木、陶瓷等。
动物座屏	构成	鸟	木雕动物座屏是楚雕塑艺术的珍品，座屏主体是以55只形态各异的凤、鸟、鹿、蛇、蛙啄咬搏斗，交织蟠绕的造像所构成，雕屏四周围长方形柜架上，。
上衣	构成	袋	3.上衣的分类有学生装、军便装、夹克衫、两用衫、T恤等等类型。穿于人体上身的常用服装。一般由领、袖、衣身、袋4部分构成，并由此4部分的造型变化形成不同款式。
冕服	构成	靴	冕服，是古代的一种礼服名称。主要由冠（冕冠）、上衣（玄色，即黑红色）、下裳（一般为红色或黄色）、舄（或靴——明制）等主体部分及蔽膝、绶、佩等其他配件相构成。
八音分类法	分类	竹	周代，我国已有根据乐器的不同制作材料进行分类的方法，分成金、石、丝、竹、匏[páo]、土、革、木八类，叫做“八音”。八音分类法是我国最早的乐器分类方法。在周末至清初的三千多年中，我国一直沿用“八音”分类法。
打捞工具	分类	锥	打捞类工具品种、规格较多，按井内落物类型分类，可分成管类打捞工具、杆类打捞工具、绳缆类打捞工具、测井仪器类打捞工具、小物件类打捞工具等五大类，若按结工具结构特点分类，则可分为锥类、矛类、筒类、钩类、篮类、其它类等六大类。
南拳虎爪	手法	拧	虎爪的手法有抓、劈、锁、掏、撩、托、拧等，不同的手法有不同的效用。为使广大读者对南拳虎爪的实战应用有所了解，现将一些常用战技介绍如下。
中医正骨疗法	手法	摩	中医正骨疗法是中医治疗骨折、关节脱位等运动系统疾病的一种方法，医生通过拔伸、复位、对正、按摩等手法，最后用小夹板外固定，治疗病人的骨伤疾病，正骨术中的"小夹板固定"属于中国首创，其后被许多国家效仿，中医正骨术堪称汉族传统医学对世界医学的伟大贡献之一。
化学水果	方法	摸	如何识别化学水果，可以使用摸、闻、掂、看的方法进行识别。
修改	方法	理	修改是指改动、删节或增添，改正，纠正修改有错误的文本，主要是为了达到提高文章质量的目的，包括四种方法：删、增、理、换。
南昌梅岭主峰	特色	俊	南昌梅岭主峰景区位于南昌市西郊30公里处，北与庐山对峙，素有“小庐山”之称，南昌梅岭主峰面积约150平方公里，山势险峻，四季景色与人，因而南昌梅岭主峰景区组成了梅岭“翠、幽、俊、奇”的特色。
乐至烤肉	特色	辣	现在乐至烤肉以其香、辣、脆、麻等特色受到了国内外食客的喜爱。
勐巴娜西珍奇园	特色	稀	勐巴娜西珍奇园汇集了全国少见的大量古树名木和世界罕见的硅化木玉石。其特色是：稀、奇、古、怪，堪称精品荟萃的旅游亮点、亚热带植物基因宝库。
广寒寺	特色	静	射洪县凉帽山广寒寺位于射洪县西部，是一个以蜀汉文化、宗教文化为内涵，以古、静、幽为特色的山地综合性佛教圣地。广寒寺，于唐代天授元年修建；建成后，多次毁于兵燹，最后一次补修于乾隆二十三年；是射洪保存最为完整的清式古建筑群。
江豆干	特色	焦	因其形似江豆，故称江豆干。有脆、焦、甜的特色。
李涌金“火柴世界”收藏馆	特色	新	李涌金“火柴世界”收藏馆于1990年5月对外开放。馆主20多年来收藏了140多个国家和地区4000多盒形状各异的火柴，他的藏品具有“奇、妙、新、少”四个特色。
禾禾面吧	特色	饼	禾禾面吧是特色饮品、米、面、粥、饼、为依托，主要以烩面、煨面、酱拌面、锅烧面、经典川式面和私房牛肉面为主的砂锅面。
脆煎饼	特色	香	脆煎饼，汉族面食食。以山东为盛，起源甚早。将五谷杂粮磨成面糊，倒入烧热的鏊子，用煎饼筢子摊平烙制而成。近年来新生煎饼的一种，口感清脆，味美主要特色，薄、脆、香、酥。
医院后勤	包括	行	它包括衣、食、住、行、水、电、煤、气、冷、热等诸多方面。医院后勤管理工作主要分为财经管理与总务管理两部分。财经管理工作包括经济管理与财务管理。总务管理工作包括物资管理、基建房产管理、设备管理和生活服务管理等。
人类活动	包括	渔	人类活动是人类为了生存发展和提升生活水平，不断进行了一系列不同规模不同类型的活动，包括农、林、渔、牧、矿、工、商、交通、观光和各种工程建设等。
半胱氨酸蛋白酶	包括	H	半胱氨酸蛋白酶包括组织蛋白酶B、H、L等，一般存在于溶酶体，主要参与细胞吞噬和细胞内多余物质的清除和消化。
旅游资讯	包括	住	旅游资讯的范围延伸很广，按照旅游界的说法，应该是涉及到旅游吃、住、行、游、购、娱六要素的各方面信息，不仅包括旅游者的信息，也包括旅游从业者得信息。
气象要素	包括	云	主要有：气温、气压、风、湿度、云、降水以及各种天气现象。扩大气象要素的概念，则它还可包括日射特性、大气电特性等大气物理特性；还有自由大气中的气象要素的说法。气象要原则上还可以包括无法测定，但可求算的、各基本要素的函数，如相当温度、位温和空气密度等。
吮指原味鸡块	口味	香	吮指原味鸡块，油炸系列的鸡肉制品。口味以咸、鲜、香为主。
冰豌豆粉	口味	酸	冰豌豆粉，是云南盛夏小吃，昆明的中老年人提起凉豌豆粉都会勾起青少年时代最温馨的回忆，至今仍是家庭自配口味的夏季凉食。其成品酸、甜、麻、辣，鲜香味浓，尤受青少年之独爱。
干煸牛肉丝	口味	咸	干煸牛肉丝是四川地区汉族传统名菜，属于川菜菜系，以牛肉为制作主料，干煸牛肉丝的烹饪技巧以干炒为主，口味属于家常味。此菜是效仿四川名菜干煸牛肉丝而制做的，面筋丝呈牛肉丝的酱红色，芹菜嫩绿鲜香，麻、辣、咸、鲜、香、甜，六味俱全，下饭佐酒皆宜。
猪手眉豆汤	口味	鲜	猪手眉豆汤属于羹/汤，主料是猪蹄，口味是鲜，工艺是炖，中级难度。
梅酱拌鸡片	口味	甜	梅酱拌鸡片是潮汕风味，红、黄、绿、白相间，色调鲜艳，为夏令佳肴。口味偏重香、浓、鲜、甜；主要用梅酱作为调味品。
糟鸡一锅端	口味	鲜	糟鸡一锅端为鸡，糟酒，番茄，胡萝卜，土豆，香菇，去皮豌豆为主料的一道菜品，口味咸，鲜。
爱鸭黑鸭王	口味	鲜	爱鸭黑鸭王，简称爱鸭，也称爱鸭连锁，隶属于江苏益客集团熟食事业部，爱鸭熟食产品以黑鸭为食材特色秘方亨制而成，口味具麻、辣、甜、鲜、香等，入口唇齿留香，令人回味无穷，是颇受消费者所喜爱的川蜀卤味熟食产品。
灌肠鸭	口味	辣	灌肠鸭整鸭一只，去内肠。先烟熏（七八分熟），再汤煮（煮至完全熟）。加料酒上色，再加若干拌菜佐之！也可随自己的口味适当地加作料，亦辣亦麻，自己喜欢就可以。
酸辣面	口味	甜	该面实为襄阳早餐之一绝；云南酸辣面昭通口味酸辣面，在昆明售卖已有几十年的历史，是人民群众常喜爱吃的经济面食；四川酸辣面具有酸、甜、香、辣、咸等不同的味道，别有一番风味。
草沟烧饼	口味	甜	草沟烧饼形状多为椭圆形，常人手掌大小而内外多层。所以吃起来外脆内酥，油而不腻，香润可口。草沟油酥烧饼以制作材料不同，总的来说共为三种，用糖的是甜的，用盐的为咸的，而用五香粉的则是五香烧饼。每一种都是不同的口味，所以很适合不同口味的的人食用。
蜜汁烤翅	口味	香	蜜汁烤翅，以鸡翅为主要原料，蜂蜜、烧烤腌料为主要调料烤制而成的一道美食，制作难度中等，口味香甜。
鲈鱼萝卜丝汤	口味	鲜	鲈鱼萝卜丝汤属于羹/汤，主要原料是鲈鱼、萝卜，口味是鲜，工艺是炖，难度属于中级。
华西琉璃灰蝶	属	琉璃灰蝶属	华西琉璃灰蝶，拉丁名Celastrinahersilia，灰蝶科、琉璃灰蝶属蝶类。
宽叶山黧豆	属	山黧豆属	宽叶山黧豆（拉丁学名：LathyruslatifoliusLinn.），豆科山黧豆属植物。
褐耳雀鹰	属	鹰属	褐耳雀鹰（学名：Accipiterbadius）为鹰科鹰属的鸟类，是一种小型猛禽，体长为31-44厘米，体重217-325克。
滇西复叶耳蕨	属	复叶耳蕨属	滇西复叶耳蕨，鳞毛蕨科复叶耳蕨属植物，植株高85厘米。
水仙花鸢尾	属	鸢尾属	水仙花鸢尾（学名：Irisnarcissiflora）为鸢尾科鸢尾属的植物，是中国的特有植物。
点囊苔草	属	苔草属	点囊苔草（学名：Carexrubro-brunneaC.B.Clarke）为莎草科苔草属的植物。
铁青树属	属	铁青树属	铁青树属（学名：OlaxL），铁青树科，约55种，分布于热带亚洲，其中铁青树O.wightianaWall.和疏花铁青树O.laxifloraMerr.3种，中国南部亦产之。
喀什菊	属	喀什菊属	喀什菊（学名：Kaschgariakomarovii(Krasch.etN.Rubtz.)Poljak.）菊科喀什菊属半灌木植物，产我国新疆（阿尔泰山区）。
滇龙胆草	属	龙胆属	滇龙胆草（滇南本草），又名坚龙胆（中国高等植物图鉴），苦草、青鱼胆、小秦艽（云南），蓝花根、炮仗花。龙胆科，龙胆属，多枝组。
展苞灯心草	属	灯心草属	展苞灯心草，灯心草科灯心草属植物，多年生草本。
茴鱼	属	茴鱼属	茴鱼是鲑形目鲑亚目茴鱼科茴鱼属的1种，又名斑鳟子。
白点富天竺鲷	属	小天竺鲷属	白点富天竺鲷（学名：Foaabocellata）为天竺鲷科小天竺鲷属的鱼类，俗名白点小天竺鲷。
长喙棘蝇	属	棘蝇属	长喙棘蝇，Phaonialongirostris（XueetZhao，1996），蝇科棘蝇属的一个物种。
凸背鳞毛蕨	属	鳞毛蕨属	凸背鳞毛蕨（学名：Dryopterispseudovaria）为鳞毛蕨科鳞毛蕨属下的一个种。
广西假毛蕨	属	假毛蕨属	广西假毛蕨（学名：Pseudocyclosorusguangxiensis）为金星蕨科假毛蕨属下的一个种。
南非兀鹫	属	兀鹫属	南非兀鹫，Gypscoprotheres（Forster,1798），脊索动物门、鸟纲、隼形目、鹰科、秃鹫亚科、兀鹫属的一种猛禽。
丁榔皮	属	灯台树属	丁榔皮是山茱萸科灯台树属植物梾木（CornusmacrophyllaWall.）以树皮入药。
绒毛长蒴苣苔	属	长蒴苣苔属	绒毛长蒴苣苔（学名：Didymocarpusdemissus）为苦苣苔科长蒴苣苔属下的一个种。
胭脂萝卜	属	萝卜	胭脂萝卜又名涪陵红心萝卜，为十字花科萝卜属二年生蔬菜作物，是涪陵三大特产之一。
银鹊树属	属	银鹊树属	TapisciaOliv.银鹊树属，省沽油科，有银鹊树T.sinensisOliv.等2种，产我国西南部和中部，供庭园观赏用。
阔羽毛蕨	属	毛蕨属	阔羽毛蕨（学名：Cyclosorusmacrophyllus）为金星蕨科毛蕨属下的一个种。
加查獐牙菜	属	獐牙菜属	加查獐牙菜，龙胆科，獐牙菜属，多年生草本植物。
太白米	属	假百合属	太白米百合科假百合属植物假百合Notholirionhyacinthinum（Wils.）Stapf以小鳞茎入药。
红头鸽	属	鸽属	红头鸽，Columbapicazuro（Temminck,1813），鸠鸽科鸽属的一个物种。
方枝树科	属	只有1属	方枝树科分布在非洲西部和南部，为小乔木或灌木，现只有1属约10种。
心叶荚蒾根	属	荚蒾属	心叶荚蒾根是心叶荚蒾（拉汉种子植物名称）的根（学名：Viburnumnervosum）为五福花科荚蒾属的植物。
脱毛喜阴悬钩子	属	悬钩子属	脱毛喜阴悬钩子（学名：Rubusmesgaeusvar.glabrescens）是蔷薇科悬钩子属的变种。
紫薯	属	番薯属	紫薯（Ipomoeabatatas(L.)Poir.旋花科Convolvulaceae番薯属）又叫黑薯，薯肉呈紫色至深紫色。它除了具有普通红薯的营养成分外，还富含硒元素和花青素。紫薯为花青素的主要原料之一。
素色杆蟋螽	属	杆蟋螽属	素色杆蟋螽（学名：Phryganogrylllacrisunicolor）是蟋螽科杆蟋螽属的一种中大型螽斯。
短裂苦苣菜	属	苦苣菜属	短裂苦苣菜（学名：Sonchusuliginosus）是菊科苦苣菜属的植物，为中国的特有植物。
武威山新木姜子	属	新木姜子属	武威山新木姜子，樟科、新木姜子属植物。
椴六点天蛾	属	六点天蛾属	椴六点天蛾，Marumbadyras(Walker，1856)，天蛾科六点天蛾属的一个物种。
翅茎草	属	翅茎草属	翅茎草，PterygiellanigrescensOliv.，玄参科翅茎草属一年生草本，干时稍变为黑色或几不变黑，直立，高约25—35厘米，有时可达50厘米，全体密被褐色具腺短柔毛。
棘刺红索藻原变种	属	红索藻属	棘刺红索藻原变种，学名Thoreahispida，红索藻科，红索藻属，生境：溪流或泉水中，着生于小石块上。
云南水东哥	属	水东哥属	云南水东哥（学名：Saurauiayunnanensis），为猕猴桃科水东哥属下的一个植物种。
何齐山醒海葵	属	山醒海葵属	何齐山醒海葵（学名：Synandwakiahozawai）为山醒海葵科山醒海葵属的动物。
乌恰贝母	属	贝母属	乌恰贝母（FritillariaferganensisLosinsk.），是百合科贝母属的植物，分布于中国新疆和吉尔吉斯斯坦的费尔干地区。
细纹狮子鱼	属	狮子鱼属	细纹狮子鱼（学名：Liparistanakae）为狮子鱼科狮子鱼属的鱼类。
黄柳组	属	柳属	黄柳组（学名：Sect.FlavidaeY.L.Chang），为杨柳科柳属灌木植物。
无梗艾纳香	属	艾纳香属	无梗艾纳香（学名：Blumeasessiliflora）是菊科艾纳香属的植物。
长柄浅黄马先蒿	属	马先蒿属	长柄浅黄马先蒿是马先蒿属的一种，玄参科植物。
贵州鼠李	属	鼠李属	贵州鼠李（学名：Rhamnusesquirolii），为鼠李科鼠李属下的一个植物变种。
暗黄鹿尺蛾	属	霜尺蛾属	暗黄鹿尺蛾，Alcissemiclarataquadrifera(Walker)，尺蛾科霜尺蛾属的一个物种。
竹叶胡椒	属	胡椒属	竹叶胡椒（学名：Piperbambusaefolium）为胡椒科胡椒属的植物，为中国的特有植物。
崖藤	属	崖爬藤属	崖藤（学名：AlbertisialaurifoliaYamamoto）为防已科崖爬藤属的植物。
东俄洛凤仙花	属	凤仙花属	东俄洛凤仙花（学名：Impatienstoxophora）为凤仙花科凤仙花属下的一个种。
长尾黄蟌	属	黄蟌属	长尾黄蟌系蜻蜓目、蟌科、尾黄蟌属蜻蜓。
秋白鲑	属	白鲑属	秋白鲑又名凹目白鲑，是辐鳍鱼纲鲑形目鲑科白鲑属的其中一种，是贝加尔湖的主要经济鱼种，有“贝加尔湖美味之称”的秋白鲑。
永安华溪蟹	属	华溪蟹属	永安华溪蟹（学名：Sinopotamonyonganense）为溪蟹科华溪蟹属的动物。
蛇葡萄	属	蛇葡萄属	为葡萄科蛇葡萄属植物蛇葡萄（东北蛇葡萄）Ampelopsissinica（Mig.）W.T.Wang.的根皮。
有机热载体炉	燃料	气	有机热载体炉，是导热油炉的常用名，俗称导热油锅炉，官方名称为热油炉。其是以煤、油、气为燃料，以导热油为循环介质供热的新型热能设备，采用高温循环泵强制导热油进行闭路循环，在将热能供用热设备后重新返回锅炉中加热的工艺流程。
手烧导热油锅炉	燃料	气	手烧导热油锅炉以煤（或油、气、电等）为燃料，以导热油为热载体，通过热油泵的强制（注入或吸出）循环，将热油通过管路输送到用热设备后再返回热油炉中，闭路循环供热。
夔州都督府	管理地区	归	夔州都督府，唐代一级行政区划名，治夔州（南朝梁至隋朝称信州，今重庆奉节），贞观十四年（640）改夔州总管府而析置，管理地区：归、夔、忠、万、涪、渝、南七州，约今重庆市全境、湖北西部。
堽城屯	姓氏	仲	堽城屯为宁阳县内较大的自然村落之一，分为东西南北四个行政村。主要姓氏有仲、任、殷、朱等。
祁庄子村	姓氏	付	祁庄子村位于宋道口镇政府西偏南3公里处。有260户，885口人。主要姓氏有赵、刘、付。
国际社会科学杂志	语言	俄	《国际社会科学杂志》是由联合国教科文组织于1949年创办的综合性社会科学期刊（季刊），使用英、法、德、俄、中、西班牙六种语言在世界范围内发行。
四梢	锻炼	指	在中国古代武术训练方法里，特别注重对于发、舌、齿、指的锻炼，并称此四个部位为四梢。特别是形意门，把四梢的修炼上升到理论的高度，特别提出四梢要齐的理论。
新疆菜	制作方法	酱	新疆菜以清真菜系为主，大多吃牛羊肉，多采用爆、烤、涮、烧、酱、扒、蒸的制作方法，著名的佳肴有烤全羊、大盘鸡、馕包肉、手抓羊肉等，口味偏酸辣。
承扶	主治	腰	承扶，经穴名。亦作扶承。出《针灸甲乙经》。别名肉郄、阴关、皮部。属足太阳膀胱经。在大腿后面，臀下横纹的中点。布有股后皮神经，坐骨神经，及与坐骨神经并行的动、静脉。主治腰、骶、臀、股部疼痛，痔疾，大便难，及坐骨神经痛，下肢麻痹或瘫痪等。
少林单匕首	主要包括	拨	少林单匕首是少林寺比较衡有的套路之一。其动作主要包括挑、扎、点、扫、拨、压、劈、拦、隔、撩等。
干青种	可加工成	坠	干青种简介，颜色浓绿悦目，色纯正不邪，硬玉结晶呈微细柱状、纤维状（变晶）集合体，晶粒肉眼能辩，透明度差，阳光照射不进，灯光约进表面lmm，质地粗粒感底干，敲击玉体音呈石声。饰品可加工成佩、坠、镯、雕件，属中―低档。
大气光学现象	主要有	华	大气光学现象是指气中发生的各种光学现象。主要有：晕、虹、华、海市蜃楼、闪烁、曙暮光、朝晚霞等。
太极尺	组合手法	绞	太极尺-----集内气、缠丝内功和养生内功之一体，分别以缠、拧、圈、绞、卷、颤等多种组合手法、辅以内气运行的内功修炼方法。
收涩药	归经	肾	又叫收涩药。性味：味多酸、涩；性多温或平。归经：主入肺、脾、肾、大肠经（可因分类不同而异）。
无机化工	主要原料是	钠	无机化工产品的主要原料是含硫、钠、磷、钾、钙等化学矿物和煤、石油、天然气以及空气、水等。
无机胶水	不含	磷	所谓无机胶水是添加剂中不含镁、磷、铝、铁等化学成分，化学活性好，防水防潮，固定碳降低量少，所谓有机胶水就是含有化学成分的胶水。
旺业甸国家森林公园	树种	松	旺业甸国家森林公园位于内蒙古自治区赤峰市旺业甸镇，与河北省隆化县、围场县相邻、属大兴安岭和燕山山脉的交接地带，植物集东北、华北群落之大成，距承德100公里，距赤峰55公里。位于喀喇沁旗西南部，有林面积34.8万亩，生长着松、柏、桦、椴等20多个树种。
土豆小葱焖饭	主要材料	米	土豆小葱焖饭是一道美食，主要材料：米1杯土豆2个大葱适量姜适量蒜适量小葱适量香菜适量辣酱适量生抽适量胡椒粉适量料酒适量鸡精适量香油适量。
地软	食用方法	烩	地软又名地木耳、地见皮、地踏菜、地皮菜、地皮木耳。生长范围很广，适应性很强。色味形俱佳，口感甚佳。似木耳之脆，但比木耳更嫩；如粉皮之软，但比粉皮微脆，润而不滞，滑而不腻，有一种特有的爽适感。食用方法很多，可炒食、凉拌、馏、烩、作羹等。
地震会商	主要遵循	中	地震会商主要遵循“长、中、短、临”渐近式预报思路，通过测震资料和前兆资料宏、微观异常的系统分析，得出地震趋势预测意见。
广州重庆大厦	服务功能	行	广州重庆大厦是重庆市人民政府驻广州办事处所属的经营实体，具备食、住、行、商贸等各种服务功能。
山东省志·气象志	层次划分	章	《山东省志·气象志》的编纂工作始于1983年，1994年正式出版。志书以篇、章、节层次划分，全书共设4篇，内容依次为天气气候、气象台站网、气象业务、气象事业管理。
清香砂锅鸡	主要原料	酒	清香砂锅鸡是一道美食，主要原料有鸡、香菇、葱、蒜、沙姜、盐、酒。
美味牛肉脯	主要原料	盐	美味牛肉脯是一道美食，主要原料为牛肉馅、盐、糖、鸡精、姜粉、白胡椒粉。
蛤蜊烩银丝	主要原料	油	蛤蜊烩银丝是一道美食，属于海鲜，主要原料为蛤蜊、白萝卜、油、盐等。
虾皮烩嫩豆腐	主要原料	姜	虾皮烩嫩豆腐是一道美食，主要原料为麻豆腐、葱、姜、干辣椒。
砂锅炖驴肉	营养成分	铁	砂锅炖驴肉是江苏省连云港地区汉族名菜，砂锅炖驴肉制作讲究，很有特色。而驴肉的营养成分也很高，含有蛋白质、钙、磷、铁等，是烹制菜肴的上好原料。
编织工艺品	原料	皮	编织工艺品是将植物的枝条、叶、茎、皮等加工后，用手工编织而成的工艺品。编织工艺品在原料、色彩、编织工艺等方面形成了天然、朴素、清新、简练的艺术特色。
纺车	原料	麻	纺车是采用纤维材料如毛、棉、麻、丝等原料，通过人工机械传动，利用旋转抽丝延长的工艺生产线或纱的设备。纺车通常有一个用手或脚驱动的轮子和一个纱锭。
麻辣豉香牛肉酱	原料	葱	麻辣豉香牛肉酱是一道菜品。原料为牛肉末、葱、姜、蒜、郫县豆瓣酱、豆豉、糖、老抽。
钢筋垫块机	原料	石	以河砂、石子、矿渣、页岩、粉煤灰等为主要原料，添加少量水泥，由该钢筋垫块机制造成型钢筋垫块，经自然养护即可使用的钢筋垫块机设备。
食品加工	原料	林	食品加工，是指直接以农、林、牧、渔业产品为原料进行的谷物磨制、饲料加工、植物油和制糖加工、屠宰及肉类加工、水产品加工，以及蔬菜、水果和坚果等食品的加工活动，是广义农产品加工业的一种类型。
绿段草	性味	凉	或呼为绿段草。高三寸许，叶如水竹于叶而宽厚，面绿有直纹，紫白圆点相间；背紫，光滑可爱。"所述及附图，与现野牡丹科植物小蜂斗草相符。性味味甘；淡；性凉。
紫河车	性味	咸	紫河车，指人类的胎盘，医认为，胎盘性味甘、咸、温，入肺、心、肾经，有补肾益精，益气养血之功。
松节	性味	温	松节SōnɡJié别名黄松木节、油松节、松郎头药材基源：为松科植物油松、马尾松、赤松、云南松等枝干的结节。性味归经为苦，温，归肝经。
白菜猪骨汤	调料	姜	白菜猪骨汤，用料：大白菜约3片、猪骨、红枣。调料：姜、盐、鸡精。
肉包	调料	糖	肉包是北方地域常食的面点，原料面皮材料：面粉400克、鲜酵母5克、水250克。馅心材料：肉沫400克、鸡蛋2个，木耳、干菇、笋各适量、葱姜适量。调料：盐、酱油、糖、美极鲜味汁、蚝油、鸡精、香油。
淡菜萝卜豆腐汤	辅料	葱	淡菜萝卜豆腐汤是家常菜，主料：淡菜50克、白萝卜500克、豆腐3快，辅料：香菇2朵、葱1根、盐适量。
腊肠蒸鱼	辅料	葱	腊肠蒸鱼原料：新鲜鱼、广式腊肠。辅料：盐、胡椒粉、白糖、料酒、生抽、姜丝、葱、辣椒。
红烧茄子肉丝	辅料	姜	红烧茄子肉丝是一道菜名，属于家常菜。主料：三根细茄子，洗净，削皮，剖称两半切成一厘米宽度的小块，里脊切丝，辅料：葱、姜、蒜。
水调面团	辅料	油	水调面团：即用各种粮食的粉料(包括面粉、米粉和其他杂粮的粉料)掺入水、油、蛋等进行调制，使面粉的粉粒和水及其他辅料相粘连，成为一个整体的团块，被称为水调面团。
清蒸猪肚菇	辅料	椒	清蒸猪肚菇是指用猪肚菇、鸡脯作为主料，配以生姜、葱、椒、黄酒等辅料制作而成的一道菜。
泸医附院	位于	黔	泸医附院位于川、滇、黔、渝三省一市结合部，坐落在四川省泸州市风景秀丽的忠山之麓，服务人口达2000多万。
综合性大学	学科	商	综合性大学是指学科比较齐全，文、理、工、商、法、医科皆有，学科门类齐全，办学规模宏大，科研实力强劲，往往是以理论性见长，综合实力上乘的大学。
脱氧核苷酸	元素组成	C	一般由C、H、O、N、P五种元素组成。脱氧核苷酸是脱氧核糖核酸的基本单位。
烟熏鸭	烹制法	卤	烟熏鸭属于四川美食中川菜菜品的冷菜一类，烟熏鸭，冷菜，烟香味型。特点：色泽金红，肉质细嫩，烟香浓郁。烹制法：腌、熏、卤。
歌乐山森林公园	自然景观	水	歌乐山森林公园位于沙坪坝区歌乐山街道，以山、水、林、泉、洞、云、雾等自然景观著称于世，被誉为“山城绿宝石”，素有“天然大氧吧”的美称。
自然硫	杂质	钛	分子式s8，理论含硫量为100%，此外，自然硫中通常含有一些杂质，火山岩自然硫往往含有少量砷、碲、硒和钛，沉积型自然硫常夹杂有方解石、粘土、有机质和沥青等。
秀丽三代虫	寄生宿主	鲤	种名：秀丽三代虫(GyrodactyluselegansNordmann,1832)寄生宿主：鲤、鲫寄生部位：体表、鳃成虫形态体长0.45-0.60mm。
海底热液多金属硫化物	富含	铁	海底热液多金属硫化物（hydrothermalsulfide）是富含铁、铜、铅、锌等金属的热液成因之海底自生沉积物。
竹溪贡米	富含	锌	竹溪贡米，湖北省竹溪县特产，唐代始封“贡米”，米质白如玉，形状似梭，粒大个长，色泽光亮，晶莹饱满，浆汁如乳，香柔可口，富含人体所需钙、铁、锌、硒等微量元素。
琉璃釉	着色剂	钴	低温色釉之一，釉料以石英为主，铁、钴、锰为着色剂，以铅为助熔剂。多为在烧好的素胎上施以琉璃釉，然后经低温二次烧造而成，主要用于装饰陶胎制品。
电子相册	表现手法	声	电子相册具有传统相册无法比拟的优越性：图、文、声、像并茂的表现手法，随意修改编辑的功能，快速的检索方式，永不褪色的恒久保存特性，以及廉价复制分发的优越手段。
谷梁赤	名	俶	名或作喜、寘、俶，字子始，山东省菏泽定陶人。相传为子夏弟子。治《春秋》，初仅口说流传，至谷梁赤，为《春秋》残亡，多所遗失，乃为经作传，称《春秋谷梁传》。
垿	名	诸侯宴会时放酒杯的土台	垿xù，古代天子、诸侯宴会时放酒杯的土台[earthtableforlayingwinecup]。徐志摩原名徐章垿。
吴公仪	名	润泽	吴公仪，名润泽，字子镇，吴家太极拳宗师吴鉴泉长子，乃吴氏太极拳代表人物之一。
常缘法师	名	常缘	常缘法师，俗姓任，名常缘，字空了，号续震、广朗。1977年农历12月25日出生于河北省张家口市怀安县柴沟堡，自幼对佛教虔诚信仰。常缘法师现为天竺禅寺住持。
谷梁赤	名	作喜	名或作喜、寘、俶，字子始，山东省菏泽定陶人。相传为子夏弟子。治《春秋》，初仅口说流传，至谷梁赤，为《春秋》残亡，多所遗失，乃为经作传，称《春秋谷梁传》。
高速列车	国家	英	到目前为止，开通高速列车的国家有日，中，法、德，意，英，俄，瑞典等国。
咎	指	过失	咎，会意字，指过失，罪过，怪罪，处分等，可用作名词，动词，常用的词语为“咎由自取”。
毛使君子	纲	双子叶植物纲	毛使君子属于植物界被子植物门双子叶植物纲使君子科使君子属分布于亚洲台湾以及中国大陆的福建四川等地目前尚未由人工引种栽培。
尼达姆蜻蜓	纲	昆虫纲	【中文名称】尼达姆蜻蜓【拉丁学名】Libellulaneedhami【命名者及时间】Westfall,1943【英文名称】Needham'sSkimmer【科属分类】节肢动物门，昆虫纲，蜻蛉目、差翅下目、蜻蜓科、Libellula属。
小纹霸鹟	纲	鸟纲	【中文名称】小纹霸鹟【英文名称】LeastFlycatcher【科属分类】脊索动物门、鸟纲、雀形目、霸鹟科。
圆叶钓皮樟	纲	双子叶植物纲	圆叶钓皮樟别名，属于被子植物门双子叶植物纲，分布在广东、广西、福建等地。
南非蹄蝠	纲	哺乳纲	南非蹄蝠，哺乳纲、翼手目、菊头蝠科的一属，而与蹄蝠属同科的动物，尚有大耳无尾蹄蝠属、金蹄蝠属、无尾蹄蝠属、非洲三叉蝠属等之数种哺乳动物。
花蜒蛇尾	纲	蛇尾纲	花蜒蛇尾（拉丁学名：Ophionereisvariegata），属于蛇尾纲蜒蛇尾科蜒蛇尾属。
罗氏圆鲹	纲	辐鳍鱼纲	罗氏圆鲹，（学名：Decapterusrusselli）又称红鳍圆鲹、红瓜鲹，俗名为红赤尾、硬尾，为辐鳍鱼纲鲈形目鲈亚目鲹科的其中一个种。
火草/柳叶草	纲	双子叶植物纲	火草/柳叶草，被子植物门、双子叶植物纲植物。
禾生盘梗霉	纲	藻状菌纲	禾生盘梗霉，藻状菌纲霜霉科植物，主要产生于黄瓜果实上。
黑喉绿阔嘴鸟	纲	鸟纲	【中文名称】黑喉绿阔嘴鸟【拉丁学名】Calyptomenawhiteheadi【命名时间】Sharpe,1888【英文名称】Whitehead'sBroadbill【科属分类】脊索动物门、鸟纲、雀形目、阔嘴鸟科。
鳠	纲	硬骨鱼纲	鳠，Mystus，硬骨鱼纲、鲇形目、鲿科（鮠科）鱯属。
怀氏彩蝠	纲	哺乳纲	怀氏彩蝠由Thomas命名为哺乳纲翼手目犬吻蝠科彩蝠属的动物。
大斑石鲈	纲	硬骨鱼纲	大斑石鲈，俗名：石鲈、头鲈、猴鲈、海猴。英文学名：Blotchedgrunt,属硬骨鱼纲、鲈形目、石鲈科、石鲈属鱼类，分布于印度洋和太平洋西部、我国南海和东海产之。
范半夏	纲	单子叶植物纲	范半夏属于单子叶植物纲，为双子叶植物药天南星科植物范半夏的块茎。
马鞍刺盖鱼	纲	辐鳍鱼纲	马鞍刺盖鱼，又称蓝肩刽盖鱼，为辐鳍鱼纲鲈形目鲈亚目盖刺鱼科的其中一个种。马鞍刺盖鱼（Pomacanthusnavarchus）又称马鞍神仙鱼，是历史比较悠久的海水观赏鱼类，因其美丽的外表长时间受到人类的关注。
南白脸角鸮	纲	鸟纲	南白脸角鸮，脊索动物门、鸟纲、鸮形目、鸱鸮科、白脸鸮属，分布于非洲中南部地区，包括阿拉伯半岛的南部、撒哈拉沙漠（北回归线）以南的整个非洲大陆。
丝藻目	纲	绿藻纲	丝藻目（Ulotrichales）是绿藻门（Chlorophyta）、绿藻纲（Chlorophyceae）的一目。
棕巨灶鸫	纲	鸟纲	【中文名称】棕巨灶鸫【拉丁学名】Pseudoseisuracristata【命名时间】Spix,1824【英文名称】CaatingaCacholote【科属分类】脊索动物门、鸟纲、雀形目、灶鸟科。
红斑塔旋螺	纲	腹足纲	红斑塔旋螺，拉丁学名为Latiruscraticulatus，其命名者是Linnaeus（1758），是一种肉食类贝壳。属于贝类动物，软体动物门，腹足纲，新腹足目、旋螺科。
马拉布鹳鸟	纲	鸟纲	马拉布鹳鸟隶属于—鸟纲——鹳科—秃鹳属—非洲秃鹳种，主要分布在撒哈拉大沙漠以南大部分地区。
荸荠丛剌盘孢	纲	半知菌纲	半知菌纲（FungiImperficti），壳霉目（Sphaeropsidales），杯霉科（Discellaceae），荸荠丛剌盘孢（Vermiculariaeleocharidis）。
艺叶兰	纲	单子叶植物纲	艺叶兰兰花品种类别。亦称“艺兰”。属于被子植物门，单子叶植物纲属。
淡边地长蝽	纲	昆虫纲	淡边地长蝽拉丁名Rhyparochromus节肢动物门昆虫纲动物。
恐鱼	纲	盾皮鱼纲	恐鱼：泥盆纪晚期，地球上出现了真正凶猛而体型巨大的动物，恐鱼是盾皮鱼纲、节颈鱼目的典型代表。
大神仙鱼	纲	辐鳍鱼纲	大神仙鱼，为辐鳍鱼纲鲈形目隆头鱼亚目慈鲷科的其中一种。
豆斑青步甲	纲	昆虫纲	豆斑青步甲是昆虫纲鞘翅目步甲科的一种昆虫。
委内瑞拉蚁鸟	纲	鸟纲	【中文名称】委内瑞拉蚁鸟【拉丁学名】Myrmecizadisjuncta【命名时间】Friedmann,1945【英文名称】YapacanaAntbird【科属分类】脊索动物门、鸟纲、雀形目、蚁鵙科。
紫革耳	纲	担子菌纲	紫革耳别名：光革耳、蘑菇，真菌类担子菌纲伞菌目伞菌科。
小猎龙	纲	爬行纲	小猎龙是脊索动物门、爬行纲、蜥臀目动物。意为“迷你的猎人”，是种兽脚亚目恐龙，化石被发现于蒙大拿州的Cloverly组，年代为早白垩纪。小猎龙是已知最原始的偷蛋龙科恐龙。
红顶雀属	纲	鸟纲	【中文名称】红顶雀属【拉丁学名】Coryphospingus【命名者及时间】Müller,1776【科属分类】脊索动物门、鸟纲、雀形目、鹀科。
喀麦隆蹄蝠	纲	哺乳纲	喀麦隆蹄蝠，哺乳纲、翼手目、菊头蝠科的一属，而与蹄蝠属（三叉蹄蝠）同科的动物尚有大耳无尾蹄蝠属（大耳无尾蹄蝠）、金蹄蝠属（金蹄蝠）、无尾蹄蝠属（无尾蹄蝠）、非洲三叉蝠属（非洲三叉蝠）等之数种哺乳动物。
丝背冠鳞单棘鲀	纲	辐鳍鱼纲	丝背冠鳞单棘鲀（Stephanolepiscirrhifer） ，又称丝背细鳞鲀，是辐鳍鱼纲鲀形目四齿鲀科的一种鱼类，分布于西太平洋区，由日本至东中国海及台湾。
长趾麦鸡	纲	鸟纲	长趾麦鸡是鸟类的一种，【科属分类】脊索动物门、鸟纲、鸻形目、鸻科、麦鸡属。
黄金蛙	纲	两栖纲	黄金蛙是两栖纲无尾目的动物，成体无尾，卵产于水中，体外受精，孵化成蝌蚪，用腮呼吸，经过变态，成体主要用肺呼吸，兼用皮肤呼吸。黄金蛙是巴拿马的国宝级动物，它的形象随处可见。但是生物学家近来发现，一种致命菌类的蔓延可能造成黄金蛙的灭绝。
阔体疣鳞苔	纲	苔纲	阔体疣鳞苔，拉丁名为ColoiejeunealatistulaZhu，是苔藓植物门苔纲的一种植物。
带凤螺	纲	腹足纲	带凤螺，拉丁名StrombusvittatusLinnaeus。生物学分类：软体动物门腹足纲中腹足目凤螺科凤螺属（拉丁文：MolluscaGastrorodaMesogastropodaStrombidaeStrombus）。
双胸蚓属	纲	寡毛纲	双胸蚓属（Bimastus）是环节动物门（Annelida）、寡毛纲（Oligochaeta）、后孔寡毛目（Opisthopora）、正蚓科（Lumbricidae）的1属。
枝核棘吻科	纲	始新棘头虫纲	枝核棘吻科（Dendronucleatidae）是棘头动物门、始新棘头虫纲、新棘头虫目的一科。
短毛莫花金龟	纲	昆虫纲	短毛莫花金龟是昆虫纲鞘翅目金龟子科的一种昆虫。
海芋属	纲	单子叶植物纲	海芋属（拉丁文名：Alocasia），别名：姑婆芋属，山芋属，是单子叶植物纲、天南星科的一属，多年生热带草本。
蝙蝠属	纲	哺乳纲	蝙蝠属（大蝙蝠），哺乳纲、翼手目、蝙蝠科的一属，而与蝙蝠属（大蝙蝠）同科的动物尚有、毛翼管鼻蝠属（毛翼管鼻蝠）、南蝠属（南蝠）、帆耳蝠属（帆耳蝠）等之数种哺乳动物。
蚊科	纲	昆虫纲	蚊科（学名Culicidae）是昆虫纲双翅目之下的一个科。
雪蝎蛉科	纲	昆虫纲	雪蝎蛉科是拉丁名叫Boreidae属于昆虫纲Insecta长翅目Mecoptera，体小，色暗的一种昆虫。
紫剑纹夜蛾	纲	昆虫纲	紫剑纹夜蛾是动物界，节肢动物门，昆虫纲，鳞翅目，夜蛾科，剑纹夜蛾属动物。
河猪	纲	哺乳纲	是脊索动物门、哺乳纲、偶蹄目动物。分布于非洲撒哈拉沙漠以南的大部分地区，其中河猪还出现于马达加斯加岛。
台湾锦叶藓	纲	藓纲	台湾锦叶藓是苔藓植物。属于藓纲，曲尾藓目。
花脸雀属	纲	鸟纲	【中文名称】花脸雀属【拉丁学名】Coryphaspiza【命名者及时间】Temminck,1822【科属分类】脊索动物门、鸟纲、雀形目、鹀科。
挪威海螯虾	纲	甲壳纲	挪威海螯虾是甲壳纲十足目动物，学名为Nephropsnorvegicus。
稀有麦穗鱼	纲	硬骨鱼纲	中文名称稀有麦穗鱼PseudorasborafowleriNichols脊椎动物门，硬骨鱼纲动物。
热溶蛋白链霉菌	纲	放线菌纲	热溶蛋白链霉菌拉丁学名Streptomycesthermoproteolyticus为放线菌纲放线菌目链霉菌科链霉菌属基中的一种细菌形态特征为孢子丝直而短孢子卵圆形至杆状表面光滑基丝无色气丝白色雪白色或微烬灰白色。
根枝水绵	科	双星藻科	根枝水绵（学名：SpirogyrarhizobrachialisJao)是双星藻科、水绵属下的一个植物种。
斐梭浦砧草	科	茜草科	斐梭浦砧草（学名：Galiumborealevar.hyssopifolium）为茜草科拉拉藤属下的一个变种。
灰毛萎软紫菀	科	菊科	灰毛萎软紫菀（AsterflaccidusBge.subsp.flaccidusf.griseo-barbatusGriers.），菊科，紫菀属植物的一种。
美国扁柏	科	柏科	美国扁柏，别名美国花柏、劳森花柏，学名chamaecyparislawspnian（A.Murr.）Parl.，柏科，圆柏属，喜排水良好的潮湿土壤。
布氏轮藻	科	轮藻科	布氏轮藻，学名CharabrauriiGmel，轮藻科，轮藻属，分布在四川，青海，湖南，湖北，贵州，云南，山东，山西，海南。
极简榕	科	桑科	极简榕（学名：Ficussimplicissima）为桑科榕属的植物。
黄杨叶栒子	科	蔷薇科	黄杨叶栒子（学名：Cotoneasterbuxifolius）是蔷薇科栒子属的植物。
猴面柯	科	壳斗科	猴面柯（学名：Lithocarpusbalansae）是壳斗科柯属的植物。
多色丽蛛	科	球蛛科	多色丽蛛，Chryssorapulum(Yaginuma，1960)，球蛛科,丽蛛属的一个物种。
圆齿假瘤蕨	科	水龙骨科	圆齿假瘤蕨，学名PhymatopterisincisocrenataChingexW.M.ChuetS.G.Lu，水龙骨科假瘤蕨属植物。
贡山栎	科	壳斗科	贡山栎（学名：QuercuskongshanensisY.C.HsuetH.W.Jen）为壳斗科栎属下的一个种，常绿乔木。
越南紫金牛	科	紫金牛科	越南紫金牛（学名：ArdisiaoxyphyllaWall.var.cochinchinensisPitard）为紫金牛科紫金牛属下的一个变种。
狼蛛属	科	狼蛛科	狼蛛属，Lycosa，蜘蛛目狼蛛科的一个属。
树头芭蕉	科	芭蕉科	树头芭蕉（学名：Musawilsonii）为芭蕉科芭蕉属的植物。
多萼小檗	科	小檗科	多萼小檗（学名：Berberiscircumserratavar.occidentalior）为小檗科小檗属下的一个变种。
豹纹斑叩甲	科	豹纹斑叩甲	豹纹斑叩甲学名Cryptalaussordidus动物界昆虫纲该物种已被列入国家林业局2000年8月1日发布的国家保护的有益的或者有重要经济科学研究价值的陆生野生动物名录。
广东临时救	科	报春花科	广东临时救（学名：Lysimachiacongestifloravar.kwangtungensis）为报春花科珍珠菜属临时救的变种。
度量草属	科	马钱科	度量草属MitreolaL.exSchaeff.，马钱科，8种，分布于美洲、亚洲和大洋洲，我国产3种，其中毛叶度量草M.pedicellataBenth，我国西南部和中部亦产之。
无毛粉条儿菜	科	百合科	无毛粉条儿菜（学名：Aletrisglabra）为百合科粉条儿菜属下的一个种。
紫雷达鱼	科	凹尾塘鳢科	紫雷达鱼，又称：（华丽线塘鳢）（学名：Nemateleotrisdecora）为凹尾塘鳢科线塘鳢属下的一个种。
丽江绿绒蒿	科	罂粟科	丽江绿绒蒿（学名：Meconopsisforrestii），为罂粟科绿绒蒿属下的一个植物种。
簇花獐牙菜	科	龙胆科	簇花獐牙菜（学名：Swertiafasciculata）为龙胆科獐牙菜属下的一个种。
长萼瞿麦	科	石竹科	长萼瞿麦，别名：长萼石竹、长筒瞿麦，拉丁文名：DianthuslongicalyxMiq.石竹科、石竹属多年生草本，高40-80厘米。
近沼生转板藻	科	双星藻科	近沼生转板藻，学名MougeotiasubpaludosaLey，双星藻科，转板藻属，生长于水塘，溪流及水库中。
指柱兰	科	兰科	指柱兰（学名：StigmatodactylussikokianusMaxim.exMakino）属微子目，兰科植物。
镇坪淫羊藿	科	小檗科	镇坪淫羊藿（学名：Epimediumilicifolium）为小檗科淫羊藿属下的一个种。
三裂山矾	科	山矾科	三裂山矾（学名：Symplocosfordii）为山矾科山矾属下的一个种。
暗色薹草	科	莎草科	暗色薹草为莎草科，薹草属下一个种，产于尼泊尔，海拔3000-4300米。
尼氏丘头鲶	科	琵琶鲶科	尼氏丘头鲶是辐鳍鱼纲鲶形目琵琶鲶科的其中一种。
淮通	科	马兜铃科	淮通为马兜铃科马兜铃属植物宝兴马兜铃AristolochiamoupinensisFranch.，以根和茎入药。
斑绿豆粉蝶中华亚种	科	粉蝶科	斑绿豆粉蝶中华亚种（学名：Coliaseratesinensis），粉蝶科，海拔区间720-2980米。
云南假卫矛	科	卫矛科	云南假卫矛（学名：Microtropisyunnanensis(Hu)C.Y.Cheng&T.C.KaoexQ.H.Chen）为卫矛科卫矛属的植物。
柳树寄生	科	桑寄生科	柳树寄生，又名柳叶钝果寄生。为桑寄生科簇生叶组灌木植物，高0.5-1米，全株无毛；二年生枝条黑色，具光泽。
白毛火把花	科	唇形科(Labiatae)	白毛火把花是唇形目(Lamiales)、唇形科(Labiatae)、火把花属(Colquhounia)植物。
米达犬吻蝠	科	犬吻蝠科	米达犬吻蝠由Sundevall命名，为哺乳纲、翼手目、犬吻蝠科、马来犬吻蝠属的动物。
山慈菇属	科	百合科	山慈菇属，学名IphigeniaKunth，百合科山慈菇族一属。
褐斑长鳍天竺鲷	科	天竺鲷科	褐斑长鳍天竺鲷（学名：Archamiafucata）为天竺鲷科长鳍天竺鲷属的鱼类，俗名褐长鳍天竺鲷。
七星鲈鱼	科	梦鲈科	七星鲈鱼，Lateolabraxjaponicus，梦鲈科花鲈属的一个物种。
鲳	科	鲳科	鲳（butterfish），硬骨鱼纲鲈形目(Perciformes)鲳科(Stromateidae)鲳属(Pampus)鱼类的统称。
多蕊木属	科	五加科	TupidanthusHook.f.etThoms.多蕊木属，五加科，只有多蕊木T.calyptratusHook.f.etThoms.1种，分布于印度、孟加拉、缅甸、越南、老挝、柬埔寨和我国云南。
桔实蕾瘿蚊	科	瘿蚊科	桔实蕾瘿蚊又称柚果瘿蚊，属双翅目蕾瘿蚊科，是一种造成沙田柚、蜜柚等柚果严重落果的危险性害虫。该虫以幼虫蛀食果肉，造成柚果腐烂和大量落果，为害损失极其严重。在春季柚类开花时，就要严防桔实蕾瘿蚊的发生为害。
小矮泽芹	科	伞形科	小矮泽芹（学名：Chamaesiumspatuliferumvar.minor）是伞形科矮泽芹属的变种。
重毫泉蝇	科	花蝇科	重毫泉蝇，Pegomyadichaetomyiola（Fan，1982），花蝇科泉蝇属的一个物种。
黑脊蛇	科	游蛇科	黑脊蛇（学名：Achalinusspinalis）为游蛇科脊蛇属的爬行动物。
浙江大青	科	马鞭草科	浙江大青（学名：Clerodendrumkaichianum）是马鞭草科大青属的植物，为中国的特有植物。
云南小花藤	科	夹竹桃科	云南小花藤（学名：Micrechitesmalipoensisvar.parvifolius）为夹竹桃科小花藤属下的一个变种。
西猴绢蝶昆仑亚种	科	绢蝶科	西猴绢蝶昆仑亚种，Parnassiussimokunlunensis(Weiss)，西猴绢蝶的一个亚种。绢蝶科绢蝶属。
簇花茶藨子	科	虎耳草科	簇花茶藨子，RibesfasciculatumSieb.etZucc.，虎耳草科茶藨子属植物。
焕镛报春	科	报春花科	焕镛报春（学名：Primulawoonyoungiana），为报春花科报春花属下的一个种。
广大头蚁	科	蚁科	广大头蚁Pheidolemegacephala，蚁科大头蚁属。
大花耧斗菜	目	毛茛目	大花耧斗菜（AquilegiaglandulosaFisch.exLink.）属毛茛目，毛茛科植物，高20-40厘米，叶片轮廓三角形，苞片披针形至长圆形，花瓣瓣片蓝色或白色，近直立，圆状卵形，蓇葖长2-3厘米，顶端宿存花柱长6-7毫米。
桔梗花拟地甲	目	鞘翅目	昆虫名，为鞘翅目，拟步甲科。分布于东北、华北、西北。桔梗花拟地甲成虫在春天喜食桔梗花苗期幼嫩的茎叶，成株期群集在根茎处啃食寄主的皮层。
狭叶五味子	目	木兰目	狭叶五味子，木兰目五味子科植物，产于四川中南部、云南西部和西北部。
非洲小雀鹰	目	隼形目	非洲小雀鹰，Accipiterminullus（Daudin,1800），隼形目,鹰科,鹰属的一个物种。
浙东副鲚鱼	目	鲱形目	浙东副鲚鱼（Paraclupeachetungensis）是鲱形目（Clupeiformes）、副鲚鱼科（Paraclupeidae）、副鲚鱼属（Paraclupea）的1种。
柳厚壁叶蜂	目	膜翅目	柳厚壁叶蜂PontaniabridgmanniiCameron又名柳瘿叶蜂。属膜翅目，叶蜂科。
锤头鹳	目	鹳形目	锤头鹳（学名：Scopusumbretta）是鹳形目锤头鹳科的涉禽，产于非洲，分布于撒哈拉以南，亦见于马达加斯加和阿拉伯半岛西南部。
球穗草	目	禾本目	球穗草为禾本目、高粱族、筒轴茅亚族、球穗草属一年生草本植物。
美图闪蝶	目	鳞翅目	美图闪蝶，Morphomattogrossensis，Morphomenelausmattogrossensis，节肢动物门、昆虫纲、鳞翅目、闪蝶科、闪蝶属的一种蝴蝶。
虎蛾	目	鳞翅目	虎蛾，Agaristidae，鳞翅目虎蛾科的通称。全世界已知约3000虎种。多分布于热带和亚热带地区。中国已知葡萄修虎蛾和艳修虎蛾为害葡萄。
闪绿宽腹蜻	目	差翅亚目	闪绿宽腹蜻，所属类别：蜻差翅亚目蜻科Libellulidae，虫体大小：体长25mm，翅展52mm。
粉莛报春	目	杜鹃花目	粉莛报春，杜鹃花目报春花科植物，生于林缘或竹林阴湿处。
中华蝠蛾	目	鳞翅目	中华蝠蛾Endoclitasinensis(Moore,1877)，是昆虫纲、鳞翅目、蝙蝠 蛾科蝙蝠蛾属下的昆虫，又称一点蝠蛾、黄斑蝙蝠蛾、蓬莱蝠蛾或甲仙蝠蛾等。
支管双钟水母	目	钟泳水母目	支管双钟水母（A.ernestiTotton），是腔肠动物门（COELENTERA[CNIDARIA]），是钟泳水母目。
墨西哥蛇皮蚓	目	无足目	墨西哥蛇皮蚓Dermophismexicanus(Mexicancaecilian)，属于两栖纲、无足目、蛇螈科、蛇皮蚓属，体长30—60厘米。
巴氏鸡鸠	目	鸽形目	巴氏鸡鸠，Gallicolumbacriniger（Pucheran,1853），脊索动物门、鸟纲、鸽形目、鸠鸽科、鸡鸠属的一个物种。
角箱鲀	目	鲀形目	角箱鲀（Lactoriacornuta），又称牛角，属鲀形目、箱鲀科、角箱鲀属，为一类外貌奇特的鲀鱼。角箱鲀分布于印度西太平洋海域，数量较多，多活动于珊瑚礁石地区，觅食小型猎物及各类有机质碎屑等，其特殊的角状结构可有效抵御天敌。
彩角青步甲	目	鞘翅目	彩角青步甲是昆虫纲鞘翅目步甲科的一种昆虫。
细鳞鲑	目	鲑形目	细鳞鲑（Brachymystaxlenok）因鳞细小而得名。属鲑形目，鲑科，细鳞鱼属。
狄氏夕划蝽	目	半翅目	狄氏夕划蝽，拉丁名是Hesperocorixadistanti(Kirkaldy)，昆虫纲半翅目动物。
松鸦西藏亚种	目	雀形目	松鸦西藏亚种（学名：Garrulusglandariusinterstinctus）是雀形目、鸦科的鸟类，体长约32厘米。
西洋杜鹃	目	杜鹃花目	西洋杜鹃（学名：Rhododendronsp），属杜鹃花目，杜鹃花科常绿灌木，最早在荷兰、比利时育成，是中国杜鹃与欧洲杜鹃经过反复杂交选育而成的，其中以春鹃为多。
葡萄瘿螨	目	甲螨目	葡萄瘿螨，属蜘蛛纲，甲螨目，瘿螨科，又名葡萄潜叶壁虱、葡萄锈壁虱、葡萄毛毡病。
匹里虫属	目	微孢子虫目	匹里虫属，是原生动物门、顶复动物亚门、孢子纲、球虫亚纲、微孢子虫目、匹里科的一属。
长尾棕蝠	目	翼手目	长尾棕蝠是哺乳动物，翼手目、蝙蝠科、棕蝠属动物。
绿背鹑鸠	目	鸽形目	绿背鹑鸠，Geotrygonveraguensis（Lawrence,1867），是鸽形目,鸠鸽科,鹑鸠属的一种鸟类，因其背部呈绿色而得名，1867年被发现并命名为绿色鹑鸠。
梨蚜	目	同翅目	梨蚜又名梨二叉蚜，属同翅目，蚜科，分布较广，国内各梨区几乎都有发生，成虫、若虫群集芽、叶、嫩梢和茎上吸食汁液。
棘吻虫属	目	棘吻目	分类地位：棘吻虫属（Echinorhynchus）是棘头动物门、古棘头虫纲、棘吻目、棘吻科、棘吻亚科的一属。
针叶树天牛	目	鞘翅目	针叶树天牛（coniferouslonghornbeetle）为害各种针叶树种的鞘翅目（Coleoplera）天牛科（Cera-mbycidae）昆虫的总称。
斑膜芹属	目	伞形目	HymenolymaKorov.斑膜芹属，伞形科，伞形目，有斑膜芹H.trichophyllum(Schrenk）Korov.和柴胡状斑膜芹C.bupleuroides（Schrenk）Korov.2种，主要分布于中亚，我国新疆亦产之。
珠蕨属	目	水龙骨目	珠蕨属为薄囊蕨纲、水龙骨目、中国蕨科其中的一属植物，通常为石缝生的小形植物。
异尖科	目	蛔目	分类地位：异尖科（Anisakidae）是线形动物门、线虫纲、尾感器亚纲、蛔目的一科。
麦氏大鳞大眼鲷	目	鲈形目	麦氏大鳞大眼鲷，为辐鳍鱼纲鲈形目的其中一个种，分布于西太平洋区，包括日本、台湾、印尼、巴布亚新几内亚、斐济及美属萨摩亚等海域，栖息深度100-200米，体长可达22.5厘米，栖息在礁石区，可做为食用鱼。
非洲海雕	目	隼形目	非洲海雕（学名：Haliaeetusvocifer）为隼形目鹰科的鸟类，是一种中型猛禽，雌性比雄性大。
土才鱼	目	鲈形目	土才鱼即沙塘鳢（Odontobutisobscurus）属鲈形目，塘鳢科，沙塘鳢属。俗称：塘鳢、沙乌鳢、土才鱼、土憨巴、土狗公。
硬叶槲蕨	目	水龙骨目	硬叶槲蕨，Drynariarigidula(Sw.)Bedd.，水龙骨目槲蕨科槲蕨属植物。
尖果白蜡	目	玄参目	尖果白蜡，FraxinusoxycarpaWilld.，玄参目木犀科白蜡树属植物。
松毛虫赤眼蜂	目	膜翅目	松毛虫赤眼蜂，TrichogrammadendrolimiMatsumura，为膜翅目，赤眼蜂科赤眼蜂属的一个物种。
冠翎岩鸠	目	鸽形目	冠翎岩鸠（学名：Geophapsplumifera）属鸟纲、鸽形目、鸠鸽科、岩鸠属。
水雉	目	鸻形目	水雉是鸻形目水雉科的一种中小型鸟类，分布于中国南方、南亚次大陆及东南亚等地区。模式产地：菲律宾吕宋岛。水雉生活在热带及亚热带的开放性湿地中，主要为淡水湖沼。
帝汶绿鸠	目	鸽形目	帝汶绿鸠，Treronpsittacea，Treronpsittaceus（Temminck,1808），脊索动物门、鸟纲、鸽形目、鸠鸽科、绿鸠属的一个物种。
双色鳚	目	鲈形目	双色鳚（学名：Ecseniusbicolor），又称双色异齿鳚，为辐鳍鱼纲鲈形目鳚科中的其中一种，俗名二色无须鳚。
白黑兵鲶	目	鲶形目	白黑兵鲶，是辐鳍鱼纲鲶形目美鲶科的其中一种。
孤斑绿菱尺蛾	目	鳞翅目	孤斑绿菱尺蛾，RhomboristamonostictaWehrli，鳞翅目，尺蛾科 的一个物种。
千岛碱茅	目	禾本目	千岛碱茅（PuccinelliakurilensisHonda）属禾本目，禾本科多年生植物，疏丛。
三孢布拉氏霉	目	霜霉目	三孢布拉氏霉，属于霜霉目、白锈科，拉丁名是Blakesleatrispora。
佛鳄龟	目	龟鳖目	佛鳄龟，是属于爬行纲、龟鳖目、鳄龟科的动物。
大别山冬青	目	无患子目	大别山冬青（学名：IlexdabieshanensisK.Yao&M.B.Deng）是无患子目、冬青科下植物，常绿小乔木，高5米，全株无毛；树皮灰白色，平滑。
非常萨克利夫木	目	髓木目	非常萨克利夫木，髓木目萨克利夫木属标本，产于甘肃靖远红土洼组1号煤层煤核。
青斑阿南鱼	目	鲈形目	青斑阿南鱼，Anampsescaeruleopunctatus，鲈形目隆头鱼科阿南鱼属的一个物种。
近海水绵	门	绿藻门	近海水绵是绿藻门双星藻科中的植物（学名：Spirogyrasubmarina(Collins)Transeau)。
红头娇鹟	门	脊索动物门	红头娇鹟：脊索动物门、鸟纲、雀形目、娇鹟科，列入《世界自然保护联盟》（IUCN）ver3.1：2009年鸟类红色名录。
单粉照水梅	门	被子植物门	单粉照水梅，学名ArmeniacamumeSieb.var.pendulaf.simplexT.Y.Chen，杏属(Armeniaca)，蔷薇科，双子叶植物纲，被子植物门，分布于东亚、中亚、小亚细亚和高加索。
衣藻	门	绿藻门	和所有植物一样同时有线粒体和叶绿体，绿藻门，衣藻科。
海洋线虫	门	线虫动物门	属于线虫动物门的无尾感器纲，分布在从潮间带直到大洋深沟的沉积物中，或附着在海藻和有机质碎屑的表面。已有可靠记录的海洋线虫有4000种。
异丝藻目	门	黄藻门	异丝藻目Heterotrichales为藻类植物之一植物目该植物于植物分类表上归于黄藻门黄藻纲。
须鴷雀	门	脊索动物门	【名称】须鴷雀【拉丁学名】Xiphocolaptesfalcirostris【命名时间】Spix,1824【英文名称】MoustachedWoodcreeper【科属分类】脊索动物门、鸟纲、雀形目、鴷雀科。
川甘毛鳞菊	门	被子植物门	川甘毛鳞菊，属被子植物门、木兰纲、菊目、菊科、毛鳞菊属。
阔瓣疣鳞苔	门	苔藓植物门	阔瓣疣鳞苔，拉丁名为Cololejeunealatilobula(Herz.)Tix.，是苔藓植物门苔纲的一种植物。
布氏原燕	门	脊索动物门	【中文名称】布氏原燕【拉丁学名】Phedinabrazzae，Phedinopsisbrazzae【命名时间】Oustalet,1886【英文名称】Brazza'sMartin【科属分类】脊索动物门、鸟纲、雀形目、燕科。
原鳄亚目	门	脊索动物门Chordata	原鳄亚目（Protosuchia）为动物界Animalia、脊索动物门Chordata、形纲Sauropsida。
胶须藻属	门	蓝藻门	胶须藻属，蓝藻门胶须藻科下的一属。
格雷维尔水绵	门	绿藻门	格雷维尔水绵是绿藻门双星藻科中的植物（学名：Spirogyragrevilleana（Hassal）Kutzing)。
斑尾食果伞鸟	门	脊索动物门	【中文名称】斑尾食果伞鸟【拉丁学名】Pipreolaintermedia形态特征形态特征【命名时间】Taczanowski,1884【英文名称】Band-tailedFruiteater【科属分类】脊索动物门、鸟纲、雀形目、伞鸟科。
小兔耳苔	门	苔藓植物门	小兔耳苔，拉丁名为ntheliajuratzkana(Limpr.)Trev，是苔藓植物门苔纲的一种植物。
七姐妹藤	门	被子植物门	七姐妹藤所属被子植物门，双子叶植物纲，分布于山谷林缘或山脚灌丛中。
类梧桐	门	被子植物门	类梧桐为落叶乔木。枝呈圆柱形，单叶对生，聚伞花序，顶生。属于菊亚纲唇形目马鞭草科，被子植物门。
春美草	门	被子植物门	春美草属于被子植物门，单子叶植物纲植被。
高凯蜣螂	门	肢动物门	高凯蜣螂（学名：CaccobiusgonoderusFaimaire）是节肢动物门昆虫纲鞘翅目金龟科的动物。
黑腺鄂报春	门	被子植物门	黑腺鄂报春（PrimulaobconicaHancesubsp.nigroglandulosa），杜鹃花目报春花科植物，产于云南西部（腾冲、庐水）。属植物界被子植物门双子叶植物纲五桠果亚纲杜鹃花目报春花科。
狭叶鞭苔	门	苔藓植物门	狭叶鞭苔，拉丁名为BazzaniaalbifoliaHorik.，是苔藓植物门苔纲的一种植物。
长叶翅膜菊	门	被子植物门	长叶翅膜菊，拉丁名为AlfrediafetsowiiIljin，是被子植物门菊科的一种多年生草本植物。
金枝藻目	门	金藻门	金枝藻目（Phaeothamniales）为藻类植物之一种。该植物于植物分类表上，归于金藻门(Chrysophyta)金藻纲(Chrysophyceae)。
疣萼细鳞苔	门	苔藓植物门	疣萼细鳞苔，拉丁名为LejeuneatuberculosaSteph.，是苔藓植物门苔纲的一种植物。
栗胁鹰	门	脊索动物门	栗胁鹰，又称栗胁雀鹰，Accipitercastanilius（Bonaparte,1853），脊索动物门、鸟纲、隼形目、鹰科、鹰亚科、鹰属的一个物种。
白腹抖尾地雀	门	脊索动物门	【中文名称】白腹抖尾地雀【拉丁学名】Cinclodespalliatus【命名时间】Tschudi,1844【英文名称】White-belliedCinclodes【科属分类】脊索动物门、鸟纲、雀形目、灶鸟科。
赭额蚁鸫	门	脊索动物门	赭额蚁鸫：脊索动物门、鸟纲、雀形目、蚁鸫科。
血梗虫属	门	扁形动物门	血梗虫属（Hamatopeduncularia）是扁形动物门、吸虫纲、单殖亚纲、锚首虫科的一属。
罗汉松属	门	裸子植物门	罗汉松属，学名PodocarpusL`Hёr.exPersoon，裸子植物门罗汉松科的一属。
蛞蝓科	门	软体动物门	蛞蝓科，软体动物门肺螺亚纲眼目的一科。
白边疣鳞苔	门	苔藓植物门	白边疣鳞苔，拉丁名为CololejeuneainflataSteph.，是苔藓植物门苔纲的一种植物。
黄喉紫须伞鸟	门	脊索动物门	黄喉紫须伞鸟，脊索动物门、鸟纲、雀形目、伞鸟科，分布于南美洲，包括哥伦比亚、委内瑞拉、圭亚那、苏里南、厄瓜多尔、秘鲁、玻利维亚、巴拉圭、巴西、智利、阿根廷、乌拉圭以及马尔维纳斯群岛（也称福克兰群岛）。
灰背唧霸鹟	门	脊索动物门	【中文名称】灰背唧霸鹟【英文名称】Slaty-backedChat-tyrant【科属分类】脊索动物门、鸟纲、雀形目、霸鹟科。
似指环虫属	门	扁形动物门	似指环虫属（Dactylogyroides）是扁形动物门、吸虫纲、单殖亚纲、指环虫科的一属。
异缪穴虫属	门	扁形动物门	分类地位：异缪穴虫属（Allomurraytrema）是扁形动物门、吸虫纲、单殖亚纲、锚首虫科的一属。
网地藻科	门	褐藻门	网地藻科，学名Dictyotaceae，藻类植物，属褐藻门。
喜马拉雅细鳞苔	门	苔藓植物门	喜马拉雅细鳞苔，拉丁名为Lejeuneastevensiana(Steph.)Mizut.，是苔藓植物门苔纲的一种植物。
爬行亚目	门	节肢动物门	爬行亚目是动物界、节肢动物门、甲壳纲、十足目的一目。
琥珀闪蝶	门	节肢动物门	琥珀闪蝶，Morphoelectra（Rober,1903），节肢动物门、昆虫纲、鳞翅目、蛱蝶科、闪蝶属的一个蝴蝶。
刺边疣鳞苔	门	苔藓植物门	刺边疣鳞苔，拉丁名为CololejeuneaalbodentataChen&Wu，是苔藓植物门苔纲的一种植物。
阔嘴鵟	门	脊索动物门	【中文名称】阔嘴鵟【中文别名】大嘴鵟【英文名称】RoadsideHawk【科属分类】脊索动物门、鸟纲、隼形目、鹰科、鵟亚科。
厚壳玉黍螺	门	软体动物门	厚壳玉黍螺，Littorinalittorea（Linnaeus,1758），属于贝类动物，软体动物门，腹足纲，中腹足目，玉黍螺科。
雉鸡弱水亚种	门	脊索动物门	雉鸡弱水亚种命名者及时间Sushkin,1926科属分类脊索动物门、鸟纲、鸡形目、雉科、雉属、雉鸡分布于中国甘肃西北部弱水下游，索果诺尔，额济纳河下游、戈壁中部以及与蒙古相邻部分（留鸟）。
芋参目	门	棘皮动物门	芋参目（Molpadida）是棘皮动物门、海参纲的一目。
象鼻贝	门	软体动物门	象鼻贝又叫象鼻蚌，软体动物门、双壳纲、海螂目、缝栖蛤科、海神蛤属。
非洲猎鹰	门	脊索动物门	非洲猎鹰，Polyboroidestypus（Smith,1829），脊索动物门、鸟纲、隼形目、鹰科、鹞亚科，分布于非洲中南部地区，包括阿拉伯半岛的南部、撒哈拉沙漠（北回归线）以南的整个非洲大陆。
叶附生苔类	门	苔藓植物门	叶附生苔类（epiphyllousliverworts）是苔藓植物门（Bryophyta）、苔纲（Bryopsida）中多附生于常绿阔叶树叶面（稀见于落叶阔叶树或草本植物上），生态上高度特化的一类植物。
黄喉鴷雀	门	脊索动物门	脊索动物门、鸟纲、雀形目、鴷雀科，黄喉鴷雀为中、小型鸟类。
碧方玉	门	被子植物门	碧方玉所属被子植物门，原产墨西哥沙漠地区，现中国南方、北方均有引种栽培。
通贝斯雀鹀属	门	脊索动物门	通贝斯雀鹀属，脊索动物门、鸟纲、雀形目、鹀科、通贝斯雀鹀属，分布于阿根廷，玻利维亚，巴拉圭，厄瓜多尔，秘鲁。
吊丝竹	界	植物界	吊丝竹（学名：D.minor(McClure)ChiaetH.L.Fung）植物界，被子植物门，单子叶植物纲，特产于中国广东、广西，现悉贵州也有。
背叶华草花蝇	界	动物界	背叶华草花蝇，分类地位：动物界>节肢动物门>昆虫纲>双翅目>花蝇科。
美花草	界	植物界	美花草（学名：Callianthemumpimpinelloides）所属植物界，属毛茛科。
担孢子	界	真菌界	真菌界，担子菌门的有性孢子。由担子经核配、减数分裂形成的单倍体细胞。生长在担子的前端，有小梗与担子相连。成熟的担孢子由小梗弹射散出，萌发后形成初级菌丝。
子囊菌纲	界	真菌界	真菌界、真菌门、子囊菌纲（Ascomycetes）本纲最重要的特征是产生子囊(ascus)，内生子囊孢子(ascospore)。
三裂瓜属	界	植物界	三裂瓜属为植物界被子植物门(Magnoliophyta)双子叶植物纲(Dicotyledoneae)，又称木兰纲。
卵叶紫菀	界	植物界	卵叶紫菀，主要分布在中国台湾，属于植物界被子植物门，双子叶植物纲，菊目，菊科，紫菀属，是一种多年生草本，茎高约100厘米，有分枝，有沟，上部被密柔毛。
袋拟扁蛛	界	动物界	中文学名：袋拟扁蛛。拉丁学名：SelenopsbursariusKarsch,1879。动物界、蛛形纲、蛛形目。
假辣子	界	植物界	假辣子为植物界樟目(Laurales)木姜子属(LitseaLam.)，是小乔木。
阿朋策犬	界	动物界	阿朋策犬所属动物界，属犬科，它的品种来源可追溯到公元前一世纪，罗马军团把古代的MOLOSSUS犬先容到瑞士阿尔卑斯地区时。
少叶艾纳香	界	植物界	少叶艾纳香是植物界被子植物门的植物。
细叶周至柳	界	植物界	细叶周至柳，属于植物界，被子植物门(Magnoliophyta)，双子叶植物纲(Magnoliopsida)，又称木兰纲。
矮香蒲	界	植物界	矮香蒲，所属植物界，是唇形科中香薷属内的物种之一，产云南西北部。
瘤子草属	界	植物界	瘤子草属为植物界爵床科，披散、被毛草本；叶对生；花小，穗状花序；有腺体；蒴果长椭圆形，种子无种钩。
柯岛浣熊	界	动物界	所属分类：柯岛浣熊为动物界脊索动物哺乳纲浣熊科。
金沙绢毛苣	界	植物界	金沙绢毛苣（别名：绢毛菊；Soroserisgillii）。真核植物界被子植物门木兰纲菊亚纲菊目菊科菊苣亚科菊苣族绢毛苣属。
荠薴	界	植物界	中文学名：荠薴，别称：臭苏、青白苏；属植物界被子植物门双子叶植物纲唇形科。
滑藤	界	植物界	滑藤为植物界萝藦科滑藤属物种之一，分布于云南南部。
黄秆金竹	界	植物界	黄秆金竹，所属植物界，属禾本科，分布在江苏、北京及浙江的杭州等地。
少毛甘西鼠尾草	界	植物界	少毛甘西鼠尾草，所属植物界，属唇形科，分布于中国大陆的四川、西藏、云南等地。
肖鸢尾属	界	植物界	肖鸢尾属，植物界，天门冬目(Asparagales)，鸢尾科，约90种，分布于南半球，我国引入栽培的有肖鸢尾M.iridioidesL.1种，广州间有栽培。
光叶珍珠花	界	植物界	光叶珍珠花，所属植物界，与原变种不同在于叶背面近无毛；花序较短，长1-2.5（-3）厘米；花梗无毛或基部有少数短柔毛；花冠坛状；子房无毛；蒴果较小，近球形或卵圆状，直径2.5-3.5毫米。
霉叶委陵菜	界	植物界	霉叶委陵菜，所属植物界，蔷薇科，生于山坡湿润地、疏林下，花黄色，花期4-5月。
白花山碧桃	界	植物界	白花山碧桃（Prunusdavidiana‘Albo-plena’），植物界，蔷薇科，落叶小乔木，是桃花和山桃的天然杂交种，观花树种。
揽蝶	界	植物界	揽蝶，所属植物界，属兰科，分布在定海。
荷奇梅	界	植物界	荷奇梅是春兰的一种，出自绍兴。植物界，被子植物门，兰科。
疏花紫	界	植物界	疏花紫，所属植物界，属虎耳草目，分布在中国。
小花酸藤子	界	植物界	小花酸藤子，所属植物界，属紫金牛科，分布广东云南、贵州等地。
星砂	界	原生生物界	星砂是一种有孔虫，是相当原始、简单的动物，空充属于原生生物界的肉足鞭毛虫门，是一种单细胞动物，这“砂”的部分其实是他们制造的碳酸钙骨骼，许多种类的骨骼呈星形，所以美其名为星砂。
山一笼鸡属	界	植物界	山一笼鸡属，所属植物界，属爵床科，分布于东南亚和中国，中国产的有多枝山一笼鸡等3种，产西南部和南部。
紫光丝膜菌	界	真菌界	紫光丝膜菌分布于吉林、西藏等地，属真菌界，伞菌目，丝膜菌科。
狗肝菜属	界	植物界	狗肝菜属，所属植物界，属爵床科，分布于热带和亚热带地区，我国有1－2种，产西南部至东南部。
斑瓣虎耳草	界	植物界	斑瓣虎耳草，所属植物界，属虎耳草科，以全草入药，具有除湿利尿，行血祛瘀，消肿的功效。
斜枝长喙藓	界	植物界	斜枝长喙藓，属植物界，苔藓植物门，藓纲。
风欢楠	界	植物界	风欢楠，植物界，肉豆蔻科植物，在山谷，山谷阔叶林中，疏林中生存，生活在最低海拔140-最高海拔1200范围内，非中国特有，非人工引种栽培，在我国海南，广东，广西自治区，云南分布，国外分布于缅甸、印度安达曼群岛、印度东北部等。
草原勿忘草	界	植物界	草原勿忘草属于植物界被子植物门单子叶植物纲禾本目禾本科分布于长白山地区。
球兰组	界	植物界	球兰组，属于植物界，种子植物门，双子叶植物纲，菊亚纲，龙胆目，萝藦科，马利筋亚科，牛奶菜族，球兰属，球兰组，中国产21种，3变种，2变型。
胖夜蛾	界	动物界	胖夜蛾，所属动物界>节肢动物门>昆虫纲>鳞翅目>夜蛾科>胖夜蛾属，体长24mm，翅展56-68mm。
隐子草属	界	植物界	隐子草属（学名：CleistogenesKeng），所属植物界，属禾本科，分布于欧洲南部以及亚洲中部和北部的干旱和半干旱地区。
吉良芋螺	界	动物界	吉良芋螺是动物界软体动物门，腹足纲，芋螺科，常分布于日本、越南。
松鹤素	界	植物界	松鹤素，所属植物界，属兰科，春兰属。
长序冷水花	界	植物界	中文学名是长序冷水花植物界一种，中文别名：大冷水花；三脉冷水花；大冷水麻；胡椒草；野牡丹叶冷水麻，中国分布于台湾、广东、广西、贵州、西藏。
大胡红	界	植物界	大胡红为植物界虎耳草目芍药属，分布在中国。
丘北铁线莲	界	植物界	丘北铁线莲，所属植物界，属毛茛科，产云南中南部（双柏，邱北）。
蚕豆核盘菌茎腐病	界	真菌界	蚕豆核盘菌茎腐病，主要发生在长江流域，属于真菌界，子囊菌亚门，一般2～4月始发，4～5月扩展较快，大多危害蚕豆的茎花部位。
黄脉爵床属	界	植物界	黄脉爵床属为植物界被子植物门(Magnoliophyta)双子叶植物纲(Magnoliopsida)，又称木兰纲，分布于南美洲，我国南部至台湾省栽培有黄脉爵床S.nobilisHook.f.1种。
茶花白轮蚧	界	动物界	茶花白轮蚧，所属动物界，属盾蚧科，分布在华南、西南、华中、华东等地。
贝氏新小羚	界	动物界	贝氏新小羚为动物界偶蹄目Artiodactyla贝拉羚属Dorcatragus。
微柱麻属	界	植物界	微柱麻属（ChamabainiaWight）所属植物界，属荨麻科，分布于印度、马来西亚及中国西南部和台湾。
黄壮异蝽	界	动物界	黄壮异蝽，属动物界>节肢动物门>昆虫纲>半翅目>壮异蝽>壮异蝽属，未列入保护级别。
冬红属	族	大青族	冬红属，学名HolmskioldiaRetz.，马鞭草科大青族的一个属。
史赘斯曼氏虹彩吸蜜鹦鹉	族	虹彩吸蜜鹦鹉族	史赘斯曼氏虹彩吸蜜鹦鹉（拉丁学名Trichoglossush.stresemanni、英文名称Stresemann'sLorikeet）属于鸟纲、鹦形目、鹦鹉科、虹彩吸蜜鹦鹉族，它们主要栖息于印尼的卡拉欧吐瓦岛（Kalao-tuaIsland）上。
十万错属	族	爵床族	十万错属为爵床科、爵床族下分一属，约70种，分布于东半球热带地区。
刺葵族	族	刺葵族	刺葵族（学名Trib.PhoeniceaeDrude）是棕榈科下的一个属，为灌木或乔木植物。
五彩芋属	族	芋族	五彩芋属，学名CaladiumVent.，天南星科芋族五彩芋属植物。
双节早熟禾	族	早熟禾族	双节早熟禾属于早熟禾属，早熟禾属（PoaLinn.）是被子植物门早熟禾族下的一个属，该属均为多年生，疏丛型或密丛型草本。
假牛鞭草属	族	单穗草族	假牛鞭草属是禾本目、早熟禾亚科、单穗草族下分一属。
披针叶野丁香	族	鸡矢藤族	披针叶野丁香，植物，属被子植物门、双子叶植物纲、合瓣花亚纲、茜草目、茜草科、茜草亚科、鸡矢藤族、野丁香属。
扁莎属	族	莎草族	扁莎属，学名PycreusP.Beauv.，莎草科莎草族的一个属。
山莨菪属	族	茄族	山莨菪属，学名AnisodusLinketOtto，茄科茄族一属，多年生草本或亚灌木。
岭罗麦属	族	栀子族	岭罗麦属，学名TarennoideaTirveng.etC.Sastre，茜草科栀子族的一个属。
宽叶百里香	族	塔花族	宽叶百里香（学名：Thymuspulegioides），属于双子叶植物纲，管状花目，唇形科，塔花族，百里香属。 宽叶百里香植株展开的小灌木，开粉紫红管状小花，花期为晚春到初夏开花，叶片为中绿色披针叶、香味浓郁。
新型兰属	族	树兰族	新型兰属，学名NeogynaRchb.f.，兰科树兰族下一属。
显脉香茶菜	族	香茶菜族	显脉香茶菜又叫大叶蛇总管、蓝花柴胡、脉叶香茶菜等，属唇形目、唇形科、罗勒亚科、香茶菜族物种。
天蓬子属	族	茄族	天蓬子属，学名AtropanthePascher，茄科茄族一属。
底波兰奇氏虹彩吸蜜鹦鹉	族	虹彩吸蜜鹦鹉族	底波兰奇氏虹彩吸蜜鹦鹉，鹦鹉科、虹彩吸蜜鹦鹉族，主要栖息于新加勒多尼亚（NewCaledonia）和忠诚岛（LoyaltyIslands）。
木瓜榄属	族	栀子族	木瓜榄属，学名Ceriscoides(Hook.f.)Tirveng.，茜草科，栀子族。
山莴苣属	族	菊苣族	山莴苣属，学名LagediumSojak，菊科菊苣族的一个属。
心叶报春茜	族	耳草族	心叶报春茜，金鸡纳亚科耳草族草本植物，为我国特有物种，生于水边阴处，分布于广西等地。
意大利红门兰	族	红门兰属	意大利红门兰（学名：Orchisitalica），也称意大利男人兰、金字塔猴子兰、睾丸兰，为兰族红门兰属的一种，植株高20-50厘米，花顶生，为发白的粉红色或紫色，花被片为头盔状，有暗色条纹，整朵花的造型就像一个戴着草帽的裸体男人。
石龙刍属	族	割鸡芒族	石龙刍属，学名LepironiaL.C.Rich.，莎草科割鸡芒族的一个属。
樫木属	族	鹧鸪花族	樫木属，学名DysoxylumBl.，楝科、鹧鸪花族一属。
槲寄生属	族	槲寄生族	槲寄生属，桑寄生科，槲寄生族，寄生性灌木或亚灌木。
水蛇麻属	族	水蛇麻族	水蛇麻属，学名FatouaGaud.，桑科水蛇麻族一属，草本。
细花福王草	族	菊苣族	细花福王草，菊科菊苣族植物，主要分布在四川地区。
溪楠属	族	玉叶金花族	溪楠属，学名KeenaniaHook.f.，茜草科玉叶金花族的一个属。
田菁属	族	刺槐族	田菁属（拉丁学名：SesbaniaScop.），豆科，刺槐族，草本或落叶灌木，羽状复叶；托叶小；早落；总状花序腋生于枝端；花梗纤细；花萼阔钟状，子房线形，花柱细长弯曲，荚果常为细长圆柱形，种子多数,圆柱形。
破坏草	族	泽兰族	紫茎泽兰（学名：Ageratinaadenophora），又名解放草、破坏草、马鹿草、大黑草、花升麻、细升麻，为菊科泽兰族假藿香蓟属多年生草本植物或亚灌木，原产于墨西哥，自19世纪作为一种观赏植物在世界各地引种后，因其繁殖力强，已成为全球性的入侵物种。
浓子茉莉属	族	栀子族	浓子茉莉属，学名FagerlindiaTirveng.，茜草科栀子族的一个属。
滇西蒲桃	族	蒲桃族	滇西蒲桃是桃金娘科、蒲桃族、小花蒲桃组、高檐蒲桃系乔木。
绒头假糙苏	族	野芝麻族	绒头假糙苏，学名ParaphlomistomentosocapitataYamamoto，唇形科野芝麻族假糙苏属植物。
染料木属	族	染料木族	染料木属，学名GenistaLinn.，豆科、染料木族的一个属。
环根芹属	族	美味芹族	环根芹属，学名CyclorhizaShehetShan，伞形科，美味芹族。
瘤囊薹草	族	薹草族	瘤囊薹草属于被子植物门薹草族植被。
统帅青凤蝶	族	凤蝶族	统帅青凤蝶（Tailedjay，学名Graphiumagamemnon），凤蝶亚科青凤蝶族下的一种蝴蝶。多出现于林区，飞行快速，雌蝶在食草产卵时会较易观察。统帅青凤蝶展翅宽70至80毫米，翅膀上布满细碎的绿色斑纹，有翅尾。
辐花苣苔属	族	苦苣苔族	辐花苣苔属，学名ThamnocharisW.T.Wang，苦苣苔科苦苣苔族下一属。
钩子木属	族	刺蕊草族	钩子木属，学名Rostrinucula，唇形科刺蕊草族下一属。
鬟刺属	族	黍族	鬟刺属，学名SpinifexL.，禾本科黍族的一个属。
菲尔科西亚属	族	水八角族	这个新加入的成员对食虫植物界来说，绝对是一个振奋人心的消息！菲尔科西亚属(Philcoxia)分类为车前草科(Plantaginaceae)的水八角族(Gratioleae)。
高山糙苏	族	野芝麻族	高山糙苏，学名Phlomisalpina，唇形科野芝麻族糙苏属植物，为多年生草本，高20—50厘米，具绳索状的根。
钻水鸭	族	鸭族(Anatini)	钻水鸭，是构成雁形目(Anseriformes)鸭科(Anatidae)鸭亚科(Anatinae)鸭族(Anatini)鸭属(Anas)约38种和其他属的5种水禽。
周承恩	号	碧峰	周承恩（?～1822）字君然，号碧峰，本籍福建。
大圭	号	梦观	大圭：是古代皇帝所执的玉质手板。形状狭长而锐上，略似剑叶。大奎，俗姓廖，字恒白，号梦观，元·泉州晋江人，是元末闽南著名诗僧。
谢谔	号	艮斋	谢谔（1121～1194）字昌国，号艮斋，一说定斋，人称艮斋先生、桂山先生，新喻（今属江西）人。
廖世德	号	枣村	廖世德，生卒年月不详，字荣先，号枣村，清康熙辛卯科举人，广西钟山县燕塘乡玉坡村人。
杨筠松	号	筠松	杨筠松，名益，字叔茂，号筠松，后人也称为“杨救贫”。
雷珍民	号	雷工	雷珍民，男，汉族，号雷工，雷公，1946年生于陕西合阳世代书香之家。
梁同书	号	山舟	梁同书(1723年～1815年），字元颖，号山舟，晚年自署不翁、新吾长，钱塘人。大学士梁诗正之子。梁同书生性重孝，以书法著名。
马良忠	号	咽铁	马良忠，别名忠良，字源项，号咽铁，1954年生，河南省项城市人，1988年毕业于中国书画函授大学书法专业。
付志鹏	号	琦峰	付志鹏，满族，富察·戴敏得，字凤翼，号琦峰，1976年生于黑龙江省宁安，现为中国美术艺术家协会常务理事；黑龙江省美术家协会会员；北京画院王明明工作室画家；北京文化部诗书画院理事；黑龙江省非物质文化遗产传承人；中国萨满文化研究所职业画家；。
陈声聪	号	壶因	陈声聪字兼与，号壶因、荷堂，福建闽侯人。
李材春	号	木子山人	李材春1933年3月生，湖南安仁县人。字湘安，号承西、木子山人。
李夏荣	号	铁研斋主	李夏荣，1964年生，字禹生，号铁研斋主，草虫之居主人，江苏如东人。
童剑峰	号	见峰	童剑峰，男，1975年1月9日生于浙江宁波，字宗林，号见峰、见丰，鄞州人，八岁拜师学习书画，十三岁曾居天童禅寺藏经楼抄录经文。
帅民风	号	三草	帅民风，字秀野，号三草，室名三契轩，汉族，1958年3月25日出生，桂林人。
石银鹿	号	子兴	石银鹿字振华，号子兴，1938年7月诞生于段家庄。
郑一初	号	紫坡	郑一初，字朝朔，号紫坡，揭阳县官溪都蓝桥乡（今榕城区仙桥篮兜村）人，生于明朝成化十二年（1476）。
戴克诚	号	秀水居	戴克诚，男，字石夫，号秀水居士，斋属“秀水草堂”、“秀水山庄”，河南郑州市人，祖籍河南省夏邑县，1964年11月生。
陆九渊	号	象山	陆九渊(1139-1193)，字子静，号象山，汉族，书斋名“存”，世人称存斋先生，江西抚州市金溪县陆坊青田村人。
瞿圆初	号	一禅	瞿圆初（?～1932）原名瞿世玮，字稚彬，号一禅。
沈晦	号	胥山	沈晦，钱塘（今浙江杭州）人，字元用，号胥山。
董应举	号	见龙	董应举(1557?1639)字见龙，号崇相，连江？头龙塘人。
白元鹤	号	天涯浪子	白元鹤，字，天鹰，笔名长白山人，号天涯浪子。
夏京州	号	汉风堂主人	夏京州，字草盛，号汉风堂主人、九州草盛、南院漫士、雪父等。
秦丘	号	枯竹斋主人	秦丘，姓李，字之锋，号枯竹斋主人，笔名秦丘。
潘公展	号	公展	潘公展(1894—1975)，原名有猷，字干卿，号公展，吴兴（今湖州）人。曾任中国公学校长、《晨报》社长、《申报》董事长等。著有《罗素的哲学问题》等。潘公展毕业于上海圣约翰大学。
陈文武	号	石痴	陈文武，字百川、号石痴、雅文阁主、砚田耕夫。
葛尊	号	雪斋	葛尊，（清·画家）浙江海宁市郭店人，生卒年不详。字龙芝，一作龙芷，号雪斋，诨名聋子（其耳实聋），曾见署款尊贤，从艺活动大约经历道光、咸丰、同治、光绪、宣统五朝，民国初仍在世，享寿甚高。
邹宗松	号	林海一松	邹宗松，男，福建福州人，1943年出生于福建福州，字鹤龄，号林海一松。
应大猷	号	容庵	应大猷（1487年－1581年），字邦升，号容庵，浙江仙居县下各村人。
韩希琦	号	无闷	韩希琦(1873～1933年)，字君玉，号无闷，漳州诏安人。
史继偕	号	联岳	史继偕（1560-1635年），字世程，号联岳，一说莲岳，明泉州晋江大房人，生于明嘉靖三十九年（1560）九月，历宦神宗、光宗、熹宗约三十二年之久。
潘英琪	号	伴墨斋主人	潘英琪，1954年生，字迹杰，号伴墨斋主人，山东莱州市人。
胡家鼐	号	燮臣	胡家鼐[近现代]字公调，号燮臣，胡家行五，胡家钰之兄，民国时期热河人，祖籍浙江绍兴上虞大胡庄。
石家绍	号	瑶辰	石家绍，字衣言，号瑶辰，封壁村人。
单国防	号	奈古山人	单国防，字默石，号双道人、奈古山人。
沈有容	号	宁海	沈有容（1557～1627），字士弘，号宁海，宣城市洪林镇 (今属安徽）人。
余耒	号	哲思轩居士	余耒（1984--0000），字思之，号哲思轩居士。
郭宏军	号	孤云	郭宏军字南南，号孤云，群众文化艺术工作者。
陈襄	号	古灵先生	陈襄（1017～1080）北宋理学家、“海滨四先生”之首，仁宗、神宗时期名臣。字述古，因居古灵，故号古灵先生，与郑穆、陈烈、周希孟并称“古灵四先生”，侯官（今福建福州）人。
韩正己	号	集萃斋主	韩正己（1964~））号集萃斋主，字闲欧。
侯尧封	号	复吾	侯尧封，字钦之，号复吾，明代紫堤村（今上海县诸翟镇）人，隆庆五年辛未科进士，任刑部主事，改四川道御史，继巡抚福建，终任福建代理布政使，以老告归。侯尧封是诸翟侯氏以后能形成当地巨族的重要一员，其后出现的侯氏名人侯震旸、侯峒曾、侯岐曾等都是他的子孙。
吴中坚	号	天柱	吴中坚(?～1951)，字炳鑫，号天柱，花名豆腐仔，广西百色市百色镇大巷人。
陆费墀	号	颐斋	陆费墀（？—1790），陆费，复姓，字丹叔，号颐斋。
田寿彭	号	稼石老农	田寿彭，（1926~）原名多获，字真如，号真如，稼石老农、石痴生。
胡若思	号	琴人	胡若思(1916.3—2004)，字遐思，号琴人。
王补石	号	桃华石	王补石（1942~）字商岩，号桃华石，别署商山布衣、方寸司马。
冯景夏	号	伯阳	冯景夏(1663—1741)，字树仁（一作树臣），号伯阳，清浙江桐乡人。
余寄寒	号	小石	余寄寒男，1948年12月生，上海市嘉定人。字天帆、号小石、别署寒竹斋主。
张芹香	号	自强	张芹香（1890.9～1941?夏）字泮藻，号自强。
路运忠	号	清莲雅士	路运忠，男，字乐善，号清莲雅士，汉族，1951年11月出生，山东茌平西路庄人，中共党员。
陈鸣秋	字	韵庵	陈鸣秋[清]字韵庵，号屏樵，闽县（今福州）人。
平江锁金	字	若溪	平江锁金，原名周祥林，字若溪，号青堂，又名平江锁金、平江。南京人，家属书香门第，母亲是京剧名伶程砚秋的传人。平江锁金在很小的时候就到部队里当了一名文艺兵。
张瑄	字	水石	张瑄，字水石，号明澈，大学文化启功先生学生。
宗演	字	洪岳	字洪岳，号楞伽窟、小厮子、不可往子。幼名常次郎。十二岁从越溪守谦出家，改名宗演。
焦金鹏	字	润酉	焦金鹏，字润酉，号长乐，丙辰年出生于中国盘古圣地泌阳县。
俞国儿	字	古耳	俞国儿（1958—）字古耳，号醉墨堂人、南明居士。
何道生	字	立之	何道生[清]（1766—1806），字立之，号兰士，山西灵石人。
崔茂善	字	雅喆	崔茂善，男，高级园林工程师，字雅喆，号乐天，云南宣威人。
方守彝	字	伦叔	方守彝（1845一1924)，字伦叔，号清一老人。
郭逢挺	字	郭果	郭逢挺河南省获嘉县人字郭果号静轩曾用名郭逢亭1952年毕业郑州师范先后在建国初期的郑州三区市政府郑州人民公园宣传组工作历任职工教育美术培训专业美术工作者。
陈玉辉	字	达卿	陈玉辉明（约公元一六一五年前后在世）字达卿，号荆碧，惠安人，今辋川镇后坑村人。
高祖宪	字	亦作幼尼、又宜	高祖宪（1870～1943）字又尼，亦作幼尼、又宜。
黄廷宣	字	汝为	黄廷宣，字汝为，号东村，福建莆田城关东里巷人。正统五年（1510）庚午，福建布政司乡试中式第一人为黄廷宣，邑人在城关后街为庚午解元黄廷宣等二十八人立“应宿坊”。
陈散原	字	伯严	陈散原(1853-1937)，字伯严，号散原，江西义宁州（今修水县人），其父是曾任湖南巡抚的陈宝箴，晚清四公子之一，其子陈寅恪，是中国著名的历史学家。
李镇东	字	修罗	李镇东，字修罗，号东邪，中国双节棍职业传播者，中国武汉凌云棍道双节棍俱乐部创始人。
招子庸	字	铭山	招子庸，原名功，字铭山，号明珊居士。广东南海横沙人。 招子庸出生于书香之家，其文笔矫健，诗文造诣颇深，亦善画工笔画，且精通韵律。
金之纯	字	健之	金之纯，生卒年月不详，字健之，号复滨，明末湖北广济人。
宋友林	字	秀良	曾用名宋友林字秀良，号双清斋主，别署普心斋主。
胡胤嘉	字	仁和人	胡胤嘉（1570-1614）字休复，仁和人。
毕泷	字	涧飞	毕泷，乾隆、嘉庆年间人，字涧飞，号竹痴，江苏镇洋（今江苏太仓）人。赵溶婿，秋帆制府毕沅之胞弟（毕沅是乾隆年间的状元、大学者，生平亦喜爱金石书画，家中收藏颇为丰富，曾购得《清明上河图》，画上便有毕泷、毕沅二人印记）。
钟国珍	字	佩玉	钟国珍，男，字佩玉，号官玖，清光绪三十三年(1907年)生，十方镇来福村人。
沈彦曾	字	士芙	沈彦曾[清]（约公元一八四o年前后在世）字士芙，号兰如，江苏长洲人。
陈宗洛	字	舒怀	陈宗洛1936年出生，字舒怀，号展鹏，河南博爱人，中共党员，中医正骨副主任中医师，河南省鹤壁市中医正骨研究所所长。
端木国瑚	字	子彝	端木国瑚（1773年-1837年），字子彝、鹤田、井伯，晚号太鹤山人，今浙江省青田县城太鹤山麓人。
冯仆	字	纯贤	冯仆（550~584），字纯贤，号独统，冯宝、冼夫人的儿子。
徐光虎	字	松竹	徐光虎，字松竹，号江南双笔，1986年出生于江西彭泽，2008年毕业于江西蓝天学院，现为中国硬笔书法协会会员，浙江省硬笔书法家协会会员。
施尧臣	字	庆甫	施尧臣（1493—1586），字庆甫，号华江，明代青阳县（今安徽青阳）人，嘉靖二十九年（1550）进士。
张若霈	字	云举	张若霈，字云举，号北冲，安徽桐城人。
邹忠倚	字	于度	邹忠倚，字于度，号海岳，江苏无锡泰伯乡人，生于明朝天启三年(1623年)。
沈廷文	字	原蘅	沈廷文（？－？），字原蘅，号元洲。
包和镜	字	润康	包和镜，生于一九四九年九月，字润康，号香炉山人，包拯二十九世孙，贵州凯里人氏，云南省农行机关老干部，实力派书法家。
颜光猷	字	秩宗	颜光猷（约公元一六九八年前后在世），字秩宗，号澹园，明末河间知府颜胤绍之孙，清廪生颜伯璟长子，山东曲阜人。
戚麟祥	字	圣来	戚麟祥，字圣来，号瓶谷，浙江德清人，清朝官员。戚麟祥回京应试，中进士，除福建连江知县。
黄启东	字	字霞鹤	黄启东（1891~1938），字霞鹤，号礼常，国民革命军第三十二军第二十三师少将参谋长，著名抗日爱国将领。
巩传深	字	黉基	巩传深，字黉基，号东方道人，1954年生于淄博恒台县，现为中国书画家协会会员，中国当代书法研究院研究员，山东美术家协会会员，山东画院画师，山东国画院理事，北京小写意书画研究院院士。
王述缙	字	公绅	王述缙[清]字公绅，号石泉，江苏太仓人。
王以憨	字	梦湘	王以憨，[清]（约公元一八九二年前后在世）字梦湘，号古伤，湖南武陵人，光绪十六年（公元一八九o年）进士。
魏建培	字	育仁	魏建培，1953年生，山东省莱芜市人。字育仁，号古镇山人。
李昕睿	字	昕睿	李昕睿，名李微微，字昕睿，号上善，藏传佛教法名文波嘉措，一亩书屋主人。
王又旦	字	幼华	王又旦（1636-1687），字幼华，号黄湄，明郃阳（今陕西省合阳）县百良乡百良村人。
刘宗向	字	寅先	刘宗向，（1879年一l951年)教育家。字寅先，号盅园，晚年又称补过生，湖南宁乡县狮子桥人。
何世玲	字	石棱	何世玲（1902—1927），字石棱、士林，别号曼侬，安徽省怀宁县江镇镇人，著名革命烈士。
潘驯	字	士雅	潘驯(1610-1681)，字士雅，号韵人。
罗纶	字	梓卿	罗纶（1876～1930），原名晋才，号康侯，字梓卿、梓青，西充县群德乡罗村沟人。
梁魁	字	美材	梁魁（？～1882），字美材，号朴樵，清代德庆州内厢人。
程兴文	字	书训	程兴文（程新文），字福勋（书勋、书训、树勋)，人称“程老五”、“五大头”，1889年5月出生。
陈经	字	伯常	陈经（生卒年不详），字伯常，号东渚，明中期大臣，益都（今青州）人。
王伯众	字	允诚	王伯众，字允诚，号悟真居士，江苏徐州人。
董其昌	字	玄宰	董其昌（1555—1636）， 字玄宰，号思白、香光居士。
苏克明	字	克明	苏克明，字进迪，号钢插公，蒙古族，蒙古苏氏始祖，为顺帝皇叔，封义王，现子孙遍布全国各地。
西镇江胡同	宽	5米	西镇江胡同，北京火车站西侧，呈东西走向，西端曲折。东起北京站西街，南止船板胡同，北有二支巷通庆平胡同。全长187米，宽5米，沥青路面。
一头沉	宽	90公分	一头沉－－写字台的一种，一般宽90公分，长110公分，有两屉的也有三屉的，在抽屉下方与桌腿相连处增加一个放文件的箱。
魏太和造像	宽	1.16米	魏太和造像，北京仅存的最完整、最古老的一尊石佛。市级文物保护单位。首都博物馆藏品。原位于海淀区聂各庄乡车耳营村北。北魏太和二十三年（499）雕刻。佛像为释迦牟尼，赤脚立姿，由一块椭圆形云岗石镌刻而成，全高2.2米、宽1.16米。
宝坻文化中心	宽	275米	规划中的宝坻文化中心，位于城区潮阳大道北侧，东西宽275米、南北长358.8米，目前处于规划中。
苏里高海峡	宽	10海里	苏里高海峡是连接莱特湾和保和海的通道，长30海里，宽10海里。
五井风景石市场	宽	1公里	【五井风景石市场】位于山东省临朐县五井镇政府驻地，五（井）冶（源）公路两侧，长3.5公里，宽1公里。
卢西塔尼亚号	宽	26.9米	卢西塔尼亚号（RMSLusitania）1907年--1915年长239.8米宽26.9米载客2165人隶属于英国卡纳德轮船公司。
仁济路	宽	8米	仁济路是中国广州市越秀区的一条南北走向的道路，位于一德路以南，沿江西路以北。长410米，宽8米。
得月亭	宽	5.5米	得月亭，位于浙江省云和县城东北部2.6公里，处在云和至处州的枫树古道间。该亭建于清嘉庆丙子年桂月吉旦，三进，二门直通。亭长9.5米，宽5.5米，高4.1米。
普雷斯帕湖	宽	12.8公里	普雷斯帕湖为巴尔干半岛的湖泊。在马其顿、阿尔巴尼亚和希腊交界处。构造湖。长23.8公里，宽12.8公里，面积285平方公里。
天门山玻璃栈道	宽	1.6米	天门山玻璃栈道，悬于天门山顶西线，长60米，宽1.6米，最高处海拔1430米。
云龙阶石	宽	3.07米	故宫三大殿之一保和殿后面三层须弥座高台正中的御路（专为皇帝用的路），由一块巨大的汉白玉雕成，这块御路石称为云龙阶石，它长16.57米，宽3.07米，厚1.07米，重量超过200吨，是紫禁城内最大的一块石料。
清早期红木凳	宽	31.4厘米	清早期红木凳，长42厘米、宽31.4厘米、高51厘米。
东风路立交桥	宽	15米	东风路立交桥长2620米，宽15米。
戊己桥	宽	1.5米	戊己桥，架于宁海县城东北24公里胡陈西张村南大麦塘口中堡溪上，石平桥，48孔，全长150米，宽1.5米，高2.47米。
俞家湾船坊	宽	5.60米	俞家湾船坊，俗名浜底下船棚。位于苏州市吴江区同里镇叶泽村俞家湾，东西走向，长，宽19.20米5.60米，水面至船坊顶部高3.67米，由12根花岗岩石柱支撑，木梁架构，蝴蝶瓦封顶，周边砌有驳岸、石河埠。
铜绿山古铜矿遗址博物馆	宽	30米	博物馆铜绿山古铜矿遗址博物馆是中国第一座反映古代矿冶科技史的专门性博物馆。位于湖北省黄石市大冶县境内。1984年12月建成开放。博物馆展览大厅长36米，宽30米，高14米。
安邱堌堆遗址	宽	500米	安邱堌堆遗址属全国重点文物保护单位，位于菏泽市东南12公里，佃户屯乡曹楼村东南约100米处。现存堌堆高3米，长宽各500米，四壁较直，断面暴露有文化层。
银鎏金錾印章图案长方盒	宽	19厘米	银鎏金錾印章图案长方盒长30厘米，宽19厘米，高7.7厘米。
大角湾旅游区	宽	50～60米	大角湾旅游区位于海陵岛闸坡镇东南，是海陵岛知名度最高的景点。美丽的大角湾滩长2.45公里，宽50～60米，螺线形湾似巨大的牛角，故名大角湾。
铜胎嵌青金石三角盒	宽	9厘米	铜胎嵌青金石三角盒长13.5厘米，宽9厘米，高5.8厘米。
铁罗汉像	宽	74cm	铁罗汉像，明弘治十年（1497年）造，高117cm，宽74cm。
冯村进士坊	宽	8.2米	冯村进士坊，石牌坊名。位于绩溪县浩寨乡冯村。四柱三门五楼，花岗石结构。高8米，宽8.2米，进深2.米。
牧畜图壁画砖	宽	17.3厘米	牧畜图壁画砖是北方牧民写真画，尺寸为长35、宽17.3厘米。
齐家文化圆雕玉人	宽	2.4厘米	这件齐家文化圆雕玉人，高5.4厘米，宽2.4厘米，前后厚2.6厘米。
合生银耳	宽	1-2cm	合生银耳，真菌植物。担子果柔软胶质，黑褐色，平展，无柄而有狭窄着生的基部，贴伏枯枝上，常作垫状或浅碟状，密集丛生彼此连结堆集卷褶而成不整形小块，长1-3.5cm，宽1-2cm，高0.2-1cm。
苏州城市形象片	宽	12.2米	苏州城市形象片展示屏位于纽约时报广场2号大楼南侧，是一块直立竖屏，长19.5米、宽12.2米，为无声纯视频屏幕。根据安排，苏州城市形象片将播放三年。
粮船	宽	十二丈	罗懋登说，粮船有七桅，长二十八丈，宽十二丈。
清雍正端石留耕砚	宽	11.2	此清雍正端石留耕砚为老坑石，右上阳文篆书“留耕”二字，左上方圆角方池。砚后楷书铭曰：“雍正二年闰四月初八日召见养心殿，赐臣余甸之砚。恭纪圣恩，子孙永宝。”砚匣为此檀木，砚长17.8、宽11.2、高2.5公分。
黄道周墓	宽	10米	黄道周墓坐南朝北，为三合土结构，宽10米，长12米，周围种满树木。
盘龙洞	宽	13米	盘龙洞深16米，宽13米，高3－4米，最高处达8米，洞内常年恒温在17度左右。
白釉黑彩蹴鞠图瓷枕	宽	19.5厘米	白釉黑彩蹴鞠图瓷枕宋代瓷器长29.5厘米宽19.5厘米高10.50厘米河南博物院征集。
民国十九年湘西苗族柳旗	宽	39.5厘米	民国十九年湘西苗族柳旗，长38厘米，宽39.5厘米。
张家港保利大剧院	宽	68米	张家港保利大剧院建筑面积22000平方米，分地下二层、地上五层，长120米，宽68米，总高度30米；由美国威尔考特顾问公司进行方案设计、上海现代设计集团进行建筑设计。
紫檀海水龙纹四扇屏	宽	40厘米	这件清中期紫檀海水龙纹四扇屏宽40厘米，高162厘米。
水上石林	宽	约500米	水上石林是黄果树下游6公里处。这里有一片长约1公里、宽约500米的袖珍型石林，一部分在陆地，一部分在水中。
双街	宽	不过两丈	双街，位于汉阳区东北角，横坐在汉水之滨：西起米行巷，东至南岸嘴，长不足400米，宽不过两丈。
布雷特580	宽	65英尺（19.8米）	“布雷特580”是是目前世界上最大的飞艇，由电子绿色科技公司研发，长235英尺（71.6米），宽65英尺（19.8米），它能够承载2000磅（907千克）的有效负荷，升至20000英尺（6096米）的高空。
目纹铜戈	宽	9.02cm	商晚期銎内式错金目纹铜戈说明：通长25cm，宽9.02cm，重593克史前的先民们制成早期的石矛，弓箭，主要用以捕获猎物，随着部落之间的战争屡屡发生，用以人与人之间拼杀格斗的“兵器”便在原史狩猎工具的基础上应运而生。
熊耳河桥	宽	6.83米	熊耳河桥，原为单孔石桥，清乾隆三年（1738)知州张钺重修，桥长34米、宽6.83米，桥孔为一伏一券式，用大方石排列砌造。
徐州铁路游泳馆	宽	21米	徐州铁路游泳馆按国际标准设立的游泳池：长50米，宽21米。
紫荆桥	宽	19米	紫荆桥位于广东省广州市天河区的华南农业大学校园内，长167米，宽19米，双向四车道（其中两条为自行车专用行车道），是华南农业大学校园内最大的桥梁，于2005年建成通车，是连接华南农业大学主校区与泰山区（原名：五山区）的一座桥梁。
六万大山	宽	30－40公里	六万大山分布于浦北、博白和玉林三个县市，主体部分在浦北县。作东北—西南走向，长约70公里，宽30－40公里。
贪泉碑	宽	0.8米	贪泉碑原位于广州西郊石门，1963年已被移至广州博物馆的碑廊。高约2.3米、宽0.8米，上面赫然丹书“贪泉”两个大字，大字上方，刻着吴隐之那首流传千古的《贪泉诗》。
备猎图	宽	360厘米	备猎图高370厘米，宽360厘米，绘于克力代乡喇嘛沟辽墓墓室西南壁。
花溪渔隐图	宽	24.5cm	《韩希孟绣宋元名迹册·花溪渔隐图》，纵33.4cm，宽24.5cm。
英雄水闸	宽	80公分	英雄水闸是1948年1月9日，我桐柏军区28旅和三分区解放邓县(今邓州)破水攻城歼敌的主要障碍。高90公分，宽80公分。
清中期紫檀长方桌	宽	66.7厘米	清中期紫檀长方桌，高86.5厘米，长163.5厘米，宽66.7厘米。
潘锡恩御文碑	宽	1.05米	清光绪帝表彰潘锡恩御文碑原在茂林镇潘村“河帅第”（潘锡恩府第）内。1980年夏移至茂林镇文化站收藏。碑高2.4米，宽1.05米，厚0.26米。
宾汉峡谷铜矿	宽	4000米	宾汉峡谷铜矿位于犹他州盐湖城附近的奥克尔(Oquirrh)山脉，这处矿坑深1200米，宽4000米，面积有7.7平方公里，是在外太空可见的人造景观之一，其大小可以想象。
花石浪遗址	高	4米	花石浪遗址是距洛南县城北3公里之县河、石门河、洛河三段交汇的夹角村东河花石浪。在花石浪东面的山坡上，有一个高约4米、宽约2米，洞深8.8米，面积约20平方米，洞内堆积有3层古人类居住面的石灰岩裂隙。
明填漆戗金云龙纹立柜	高	174	明填漆戗金云龙纹立柜，现藏于故宫博物馆，高174厘米，横124厘米，纵74.5厘米。
古斯佛瀑布	高	70米	古斯佛瀑布位于冰岛首都雷克雅未克以东北125公里外，宽2500米，高70米，为冰岛最大的断层峡谷瀑布，塔河在这里形成上、下两道瀑布，下方河道变窄成激流。
威灵道夫的维纳斯	高	11．5厘米	威灵道夫的维纳斯，约公元前15000——10000年，石灰石，高11．5厘米，宽5厘米，维也纳自然历史博物馆藏。
引路号	高	约6米	日本宇宙开发机构称，引路号卫星呈长方形，长和宽均为3米左右，高约6米，重约4吨。
玉峰霁石	高	8米	入选理由：玉峰霁石被列入安徽物质文化遗产。高8米，重3.2吨。
北汉山新罗真兴王巡狩碑	高	154cm	韩国国宝3号：北汉山新罗真兴王巡狩碑。该碑高154cm，宽69cm，记录的是新罗国真兴王（540-575年）扩展疆土的壮举（当然怎么扩也才扩到汉河附近）。
扶苏墓	高	约8米	扶苏墓呈长方形，长约30米，宽6米，高约8米，墓旁有扶苏祠，为陕西省重点文物保护单位。
八百壮士墓	高	1.2米	墓冢长方形,宽5.5米,长6.2米,高1.2米。墓碑刻“八百壮士墓”。
奥尔梅克巨石头像	高	约305厘米	奥尔梅克巨石头像，玄武岩，约公元前800年－600年，高约305厘米，重约30吨，现收藏于墨西哥国立人类学博物馆。
木雕变形鸟	高	39厘米	木雕变形鸟高39厘米，宽15厘米，厚13.5厘米。
青石牌坊	高	16.9米	青石牌坊位与辽阳广佑寺，这是目前世界上最大的青石牌坊，高16.9米，长34米，由95块青石雕刻后组合而成，重达800余吨。
长虹瀑布	高	200余米	长虹瀑布，高200余米，宽20余米，由源于军顶下的长虹溪呈多级飘然而成，绿树掩映，洋洋洒洒，迷蒙水雾经阳光照射，长现彩虹奇观，恰似一身着七彩罗裳的仙女，绚丽迷人，故名长虹瀑布，与附近壮美的响水滩相呼应，宛若一对长相守得恋人。
铜力士骑兽博山炉	高	23.9cm	铜力士骑兽博山炉，是西汉时期的薰香炉，高23.9cm，宽10．1cm。
弥勒下生经变相	高	2.72米	“弥勒下生经变相”凿于北山佛湾北段中部，编为第176窟。窟高2.72米、宽1.95米、深2.4米。
清中期沧浪亭图挂屏	高	74厘米	清中期沧浪亭图挂屏连木框高74厘米，宽106厘米。
中国南海诸岛工程纪念碑	高	8米	1991年5月11日，人民海军在永兴岛建《中国南海诸岛工程纪念碑》，高8米，宽4米的淡灰色大理石碑正面铭文“南海诸岛沧桑千年，炎黄后代创业今朝。
清拐子式书卷搭脑扶手椅	高	宽62.2厘米	清拐子式书卷搭脑扶手椅木质为楂桢木，又名柘木。高100厘米、宽62.2厘米。
巡诊机器人	高	1.63米	巡诊机器人是由“触摸健康”公司生产的RP7i巡诊机器人是目前进入医疗领域最先进的机器人。引RP7i高1.63米，重约100千克。
舜子耕田砖雕	高	19.5cm	舜子耕田砖雕，北宋，高19.5cm，宽26cm，厚3cm。
明白玉幻方	高	3.5厘米	明白玉幻方长3.6厘米，通高3.5厘米，厚0.75厘米。
闵子骞劝父砖雕	高	19.5cm	闵子骞劝父砖雕，北宋，高19.5cm，宽26cm，厚3cm。
清雍正湘妃竹绣花卉多宝格	高	86厘米	这件清雍正湘妃竹绣花卉多宝格高86厘米，宽910厘米，是一种集各种材料，各种工艺为一体的精致考究家具。
清早期金漆龙纹宝座	高	165厘米	清早期金漆龙纹宝座宝座高165厘米，长109厘米，宽60厘米。
南洼洞遗址	高	高3.6米	南洼洞遗址位于沂水县诸葛镇范家旺村西南山的山顶上。因临近范家旺村南一片洼地，故名南洼洞。洞口向南，高3.6米，宽6米，长14米，系水平溶洞。
黄山四千仞	高	一点二米	《黄山四千仞》高一点二米，长两点七米，装裱在黄色实木架上，粉彩瓷描写黄山奇峰异景，古树森茂，云海浩渺。瓷板左边题有李白游黄山时的名诗：“黄山四千仞，三十二莲峰。
圣母子和圣安妮	高	168.4厘米	圣母子和圣安妮》高约168.4厘米，长129.9厘米，背面由4块白杨木板组合而成，并由2根横梁固定。
清代竹编木胎漆器双凤盘	高	7.2cm	清代竹编木胎漆器双凤盘高7.2cm,口径长43cm,宽25cm.长方形，四角陏圆式口，矮足敞口。
寿缘桥	高	4米	寿缘桥位于仁寿县识经乡大柏村6组，属单孔拱券式石平桥，横跨一条名为“大河沟”的小河，南北走向。桥长15米，宽2.4米，高4米，用条石砌成。
漳港抗敌死难同胞纪念碑	高	约5米	漳港抗敌死难同胞纪念碑为塔式石砌三层，高约5米，碑底座边宽4米。
九成金嵌色石宝塔	高	82cm	九成金嵌色石宝塔，清朝出品，通高82cm，底径36×36cm。
双龙飞瀑	高	15米余	在雉街河上，有一令人神往的佳景——双龙飞瀑，瀑布宽40余米，高15米余，是赫章境内的第一大瀑布。每逢枯水季节，河水分成两股，瀑流从崖顶直泻向崖底，如同两条银色的蛟龙从深潭里腾空而起，双龙飞瀑由此而得名。
波帕瀑布	高	2-4公尺	波帕瀑布英文名称：PopaFalls，由于卡凡古（KavangoRiver）河水在进入博茨瓦纳和奥卡万戈三角洲的途中流经波帕瀑布，流速极快，水流冲刷地层是底层陷落而形成高仅2-4公尺，但宽却长达1.2公里的波帕瀑布。
大佛洞	高	约20米	陕西汉中大佛洞位于南郑小南海西北岸山腰上。“岸半突开一洞，中建佛殿，故名。”洞口显豁，宽约17米，高约20米。
吴氏老屋	高	7米	吴氏老屋，位于湖北省荆门市京山县钱场镇西北2公里处的吴家大湾。始建于清朝光绪17年（公元1891年)，三层建筑，外墙为土坯墙，内墙为杉木结构，装饰华丽、典雅。屋长31.2米，宽15.2米，高7米。
罗让碑	高	4.20米	罗让碑位于河北邯郸市大名县康堤口村南，立于唐昭宗龙纪元年（889年），碑青石质，高4.20米，宽1.43米，厚0.5米。
黑漆嵌螺钿加金片婴戏图箱	高	28.4cm	黑漆嵌螺钿加金片婴戏图箱，长27.5cm，宽27.5cm，高28.4cm。
铜胎掐丝珐琅饕餮纹香炉	高	26厘米	铜胎掐丝珐琅饕餮纹香炉高26厘米，口长16．9厘米，宽13．4厘米。
万龙熔椅	高	1.86米	万龙熔椅高1.86米，长1.64米，总重量达678斤，上刻成千上万条中国龙。
绘彩勾首马	高	48厘米	绘彩勾首马，三彩器，盛唐时期，高48厘米，长39厘米，河南巩义出土，现藏河南博物院。
彭祖寿石	高	16米	彭祖寿石高16米，宽8米，重约400吨，来自徐州铜山东南油山。
五鹿图	高	30厘米	该器高30厘米，口径16厘米，宽26厘米，除口部上端有一直径2厘米左右的残缺，左侧耳部有一指甲大小的残缺外，品相基本完好，尤其难得的是“五鹿图”画面光洁如新，线条清晰，历经了3000多年的漫长岁月，画面如此，实为难能可贵。
胡正蒙铭五蝠云纹端砚	高	3.4厘米	胡正蒙铭五蝠云纹端砚，明代（公元1368—1661年）。纵14.5厘米，横14.2厘米，高3.4厘米。
胜泉峡谷	高	数十米	胜泉峡谷位于四川省乐山市井研县胜泉乡，由于地壳运动，形成了一条高数十米、宽约50米、长约5公里的峡谷地带。
铜凤灯	高	33厘米	1971年在广西壮族自治区北海市合浦县望牛岭发掘的西汉晚期一号汉墓时，出土了铜凤灯一对，高33厘米、长42厘米、宽15厘米，外形仿凤鸟，双足并立，昂头回望，尾羽后曳下垂与足共同支撑全身，显得十分稳重。
竹根雕仙人乘三多槎	高	15厘米	竹根雕仙人乘三多槎高15厘米，长26厘米，宽13厘米。
太仓市现代农业展示馆	高	6.2米	太仓市现代农业展示馆长124.8米，宽48米，高6.2米，馆内配有先进的控温、通风、遮阳系统，冬季可保持在15℃以上温度，以满足馆内各类周年生长的需要。
铜山古城	高	7米	铜山古城，闽海五大水寨之一，位于东山岛东北部铜陵镇，是福建省著名的风景名胜区之一，始建于明洪武二十年（公元1387年），古城城墙依山起伏，条石砌成，长1900米，高7米。
跪坐人像	高	14.6厘米	跪坐人像宽8.2，高14.6厘米，四川省广汉市三星堆二号祭祀坑出土。
圣母子与圣安妮	高	168.4厘米	《圣母子与圣安妮》高约168.4厘米，长129.9厘米，背面由4块白杨木板组合而成，并由2根横梁固定。
戴家山遗址	长	约60米	它是属于新石器时代晚期居住遗址，是典型的台形遗址，长约60米，宽约40米。在市政府公布的镇江市文物保护单位名单中，戴家山遗址排在第一位，可见此处遗迹的重要性。
毕家墩遗址	长	120米	毕家墩遗址位于县城东南40里缺口镇村失槽河东岸。墩东西长120米，南北宽110米，面积132平方米，高4米。
蓝疆号	长	157.5m	蓝疆号大型起重铺管船是一艘非自航无限航区作业的大型工程船，船体总长157.5m,型宽48m,。
千乘桥	长	62.7米	千乘桥，位于棠口村水尾。始建于南宋理宗年间，清嘉庆二十五年（1820）秀才周大权等人再次募建。南北走向，全长62.7米，宽4.9米，桥面距水面高度9.7米。
蔡城塘	长	5.5公里	蔡城塘位于淮南市东南郊，长约5.5公里，宽500米到800米之间，约5万多亩水面。
望水泉	长	20米	泉池长20米，宽9．8米，深2．2米，中架3孔石桥，桥南建彩亭，北连过厅门楼，桥西侧北岸池壁嵌清末庚戊(1910年)“望水泉”石刻。
大将军炮	长	三五尺	大将军炮：大型火炮，身用生铁铸造，长三五尺，重五百斤，有多道加强箍，分大、中、小三种，发射7斤、3斤和1斤的铅弹，用一辆车运载。
俄罗斯岛	长	18公里	长约18公里，宽13公里。俄罗斯岛（俄语：о́стровРу́сский）是日本海彼得大帝湾内的一个岛屿，隔东博斯普鲁斯海峡与海参崴所在的穆拉维约夫-阿穆尔斯基半岛分开。
葛拉马拉岛	长	3.5公里	葛拉马拉岛，为孟加拉湾中部一座小岛，长3.5公里、宽3公里，印度和孟加拉国在20世纪70年代都分别宣称对其拥有主权，但2010年3月某日，这座小岛却因为海平面上升而消失。
都吉台	长	103米	都吉台古遗址就在“斗鸡台”上，南北长103米，东西宽22米，总面积7416平方米，文化层厚8.5米，下层为龙山文化，中层为商周文化遗存，上层有汉代遗物和唐宋遗存，内涵十分丰富。
多瑙岛	长	21.3公里	多瑙岛（Donauinsel）位于奥地利首都维也纳中部多瑙河上，为人工岛，位于48°14′N,16°24′E，长21.3公里，宽0.25公里，面积3.9平方公里，该岛是一个休闲区，岛上有酒吧，餐馆和夜总会。
广西中越全界之图	长	1764厘米	《广西中越全界之图》,长1764厘米，宽32.7厘米，清光绪十九年(1893年)七月绘成，夹萱石印，墨色浅淡均匀，楷书工整，山石树木用中国画手法勾勒。
翠镂雕荷花坠	长	2.8厘米	翠镂雕荷花坠，清，长2.8厘米，宽3.6厘米。
木嵌银箱	长	19厘米	木嵌银箱长19厘米，宽9厘米，高13.5厘米。
妃哈逅岛	长	450米	马尔代夫妃哈逅岛位于马尔代夫南马累环礁的西南部，从马累到快艇上岛需要45分钟。长450米，宽250米Fihalhohi岛拥有马尔代夫最精美的屋礁。
高山县城遗址	长	70米	高山县城遗址位于安徽省来安县新安镇东北26公里处的王集乡高山村内的高山岗上，呈方形。长70米，宽60米。
清中期紫檀平角条桌	长	174厘米	清中期紫檀平角条桌，桌体紫檀木制，平角立方式。高88.5厘米，长174厘米，宽45厘米。
明黄花梨六柱架子床	长	203.5厘米	明黄花梨六柱架子床，长203.5厘米、宽140厘米、高208.7厘米、座高51厘米。
钟亭	长	4.4米	钟亭位于伏波山南麓，还珠洞南口西侧，为单层翘檐攒尖顶4角方亭，高4.7米，宽4.5米，长4.4米，面积19.8平方米。
墙排球	长	12.19米	墙排球是近年在美国比较流行的一种娱乐性健身排球。它是在长12.19米，宽6.10米，顶高6.10米的墙球场地上架起高2.13米的网，采用三打三、二打二或四打四的形式，打法和普通排球一样，但可以利用墙的反弹，只要球不落地就可继续打。
大理洋人街	长	000米	在古城，大理洋人街原名“护国路”，意为民国初云南人民反对袁世凯称帝，起兵护国而得名。护国路东西走向，长1000米，宽7米，青石板铺面，西起滇藏公路，交博爱，复兴等主要街道。
大西洋—印度洋海岭	长	约3	大西洋—印度洋海岭（Atlantlc-IndianRidge）又名“非洲-南极海岭”。在大西洋东南部和印度洋的西南部。系南大西洋海岭的延续，东与西印度洋海岭相接。长约3，000公里，最宽450公里。
灯塔岛	长	400米	灯塔岛长400米、宽270多米，海水澄清透明，沙滩细腻洁白。灯塔岛的中央是一座建于1862年的白色灯塔。
性崆山	长	10米	上完石阶，转弯处便看见长约10米，宽半米，横卧在千米峭壁中的舍身崖，过了舍身崖，顺着直通性崆山巅的腰道直上，就到了卧虎洞。
吴淞路	长	1412米	南北走向，南起北苏州路口上海大厦接吴淞路闸桥，北至虬江路。长1412米，宽9米到28米。
假日岛	长	700米	马尔代夫假日岛位于南阿里环礁，距马累机场97公里，乘水上飞机需30分钟，快艇需2.5小时。Holiday岛仅有700米长，140米宽，是一个僻静的小岛，银白的沙滩与清澈的大海交相辉映，是一个未被破坏的天堂。
行走机	长	60厘米	其结构紧凑，长60厘米，宽30厘米，每隔三天充一次电。行走机较普通前置式轮椅更易操纵，下肢瘫患者能借助行走机自由走动。
克什米尔谷地	长	135公里	克什米尔谷地Kashmir,Valeof南亚克什米尔境内最大的河谷盆地，即杰卢姆河上游谷地。北为喜马拉雅山脉，南为皮尔潘贾尔山脉。长135公里，宽40公里。
方东树《寒崖独往图》手卷	长	5.12米	方东树《寒崖独往图》手卷1958年桐中教师姚沛生捐献，1986年移交桐城县博物馆收藏。纸本，绫裱，长5.12米，宽0.43米。
红山文化玉凤	长	19.5厘米	新石器时代红山文化玉凤长19.5厘米，高12.5厘米，厚1.2厘米。
乌石砾滩	长	500多米	乌石砾滩位于浙江舟山朱家尖樟州湾西岸，长500多米、宽近百米、高约5米，由无数块乌黑发亮的卵石自然倚坡斜垒而成。气势恢宏、蔚为壮观的乌石砾滩，每逢月夜，滩边潮音奏响，更是一绝。
苏寨民居	长	90米	苏家寨在苏寨南北大街的中间路东，有一座长90米、宽24米完整的明朝中晚期的官宅建筑群——苏寨民居，此民居既有宫廷式样，又具中原风格的建筑。
陵水湖	长	约一公里	[br/]陵水湖位于小金门西南沿海、上库村与上歧村之间，当地人说，原本这儿是一大片的低洼地，经常一雨成灾，于是在民国五十二年时，由当地的守军以人力开凿出来的澹水湖，面积广达三百八十六公顷，长约一公里，宽约一点五公里。
鸵鸟蛋	长	长达15公分	鸵鸟是世上最大的禽类动物；鸵鸟蛋，则是世上最大的蛋，鸵鸟蛋一般长达15公分，宽8公分，重量可达1.5公斤。此外，人们在鸵鸟蛋蛋壳上通过彩绘、浮雕等手段制作成相应的艺术品，即所谓的“鸵鸟工艺蛋”，亦有很高的观赏和收藏价值。
都府街	长	200多米	都府街位于广州市越秀区第一人民医院旁边，是一条只有约5米宽、200多米长的小路。
云蝠端砚	长	18.9厘米	云蝠端砚清长18.9厘米宽18厘米厚2.3厘米此砚石质细腻温润，且有蕉白火捺。
产蛋崖	长	20多米	“产蛋崖”长20多米、高6米，表面极不平整，近百枚“石蛋”错落有致地镶嵌在陡崖上，直径约30-60厘米，最重的达300余公斤。“产蛋崖”成因至今尚无定论，有专家推测其形成于五亿年前，由碳酸钙分子在特定化学作用下渐渐凝聚在一起结核而成。
孝义巷	长	约400米	孝义巷是条小巷，长约400米，最宽处不过三四米，最狭窄处仅容两人侧身而过。
毛泽东青年艺术雕塑	长	83米	毛泽东青年艺术雕塑高32米、长83米、宽41米，基座3500平方米，由8000多块采自福建高山的永定红花岗岩石拼接而成，。
峡村峡谷自然风景区	长	3500米	峡村峡谷自然风景区北为太山，海拔1732米；南为明山，海拔1615米。峡谷相对高差约300余米，长约3500米，宽约200米。
丁云鹏白描十八罗汉图卷	长	700厘米	丁云鹏白描十八罗汉图卷明代。纸本，长700厘米，宽28厘米，以淡墨素描法绘制形态各异的十八罗汉，人物之间以云气相衬托，形象逼真，栩栩如生。
马托奇金沙尔海峡	长	约1	长约1，000公里，宽40-110公里，面积8.26万平方公里。以马托奇金沙尔海峡分成南、北两岛（面积分别为3.33万和4.89万平方公里）。
朱雀山滑雪场	长	200米	朱雀山滑雪场长200米、宽50米的滑雪道为广大滑雪爱好者提供了优良的滑雪场地，并且坡度适宜，尤为适合初学者滑雪娱乐。
翡翠峡	长	28公里	翡翠峡长28公里，宽2～30米，两岸峭壁高100至250米。
祥和玉鼎	长	102厘米	祥和玉鼎长102厘米，宽70厘米，高104厘米，净重938斤，是目前中国国内乃至世界已知的最大的一尊方玉鼎。
广安里海滨浴场	长	1.4公里	广安里海滨浴场以其长1.4公里、宽64米的沙滩及优质沙子而闻名。
成吉思汗丧葬图	长	50厘米	成吉思汗丧葬图，这幅壁画绘于阿尔寨石窟第28号窟主龛右侧的上方，长50厘米，宽35厘米，画面右角绘白色蒙古包二座，尖顶高耸。
胡安·德富卡海峡	长	160公里	胡安·德富卡海峡（JuandeFucaStrait）加拿大不列颠哥伦比亚省温哥华岛和美国华盛顿州之间的海洋通道。长160公里，宽24-32公里。
抚顺矿区	长	18千米	抚顺矿区位于辽宁省抚顺市浑河南岸，长18千米，宽2千米，面积为36平方千米。
日本“岛风”号导弹驱逐舰	长	150米	日本“岛风”号导弹驱逐舰(ShimakazeMissileDestroyer)为旗风级的2号舰，于1988年3月服役。长150米，宽16.4米，吃水4.8米，满载排水量5500吨。
史前冠形器	厚	0.3厘米	史前冠形器高5.8厘米，上宽7.7厘米，厚0.3厘米。
再借亭	厚	0.16米	再借亭位于蚶江镇石湖村西北的古码头石狮蚶江石湖港“林銮渡”边，有“再借亭”一座，碑高12.71米，宽0.93米，厚0.16米，为四柱平顶拱形石亭。
明黄花梨炕柜	厚	36厘米	这对明黄花梨炕柜宽75厘米，厚36厘米，高106厘米。
曹娥投江砖雕	厚	3cm	曹娥投江砖雕，北宋，高19cm，宽26cm，厚3cm。
明万历碑	厚	26厘米	明万历碑，此碑为刑、工二部尚书潘恩所撰，主要记载青浦建城始末，对研究青浦古代历史，有很高的参考价值。碑原有篆额，为王圻所书，但早已失落。碑高220厘米，宽109厘米，厚26厘米，青石质，行书。
土字碑	厚	0.22米	土字碑，位于吉林省珲春防川中俄边界，1886年中俄重勘珲春东部边界时重立。“土”字牌高1.44米，宽0.5米，厚0.22米，为花岗岩质。
扁钢	厚	4-60mm	扁钢，是指宽12-300mm、厚4-60mm、截面为长方形并稍带钝边的钢材。扁钢可以是成品钢材，也可以做焊管的坯料和叠轧薄板用的薄板坯。主要用途：扁钢作为成材可用于制箍铁、工具及机械零件，建筑上用作房架结构件、扶梯。
孔雀瑞兽葡萄镜	厚	1.5厘米	孔雀瑞兽葡萄镜，《镇原县志》称为“海马燕子葡萄镜”。它的直径为19.7厘米，厚1.5厘米，重1900克。
睒子鹿乳奉亲砖雕	厚	4.5cm	睒子鹿乳奉亲砖雕，北宋，高31.5cm，宽30cm，厚4.5cm。
清青玉蝴蝶	厚	0.7厘米	清青玉蝴蝶长9.2厘米，高5.2厘米，厚0.7厘米。
红漆描金云龙纹排箫	厚	3.3cm	红漆描金云龙纹排箫，清康熙，通高33.7cm，宽35.8cm，厚3.3cm。
兽面纹扁足鼎	重	4850克	兽面纹扁足鼎是一件商朝青铜礼器。它通高31.1厘米，口径24.2厘米，重4850克。
三角钢琴	重	最重的可达79吨	音乐会所用的大三角钢琴是乐器中的庞然大物，有9英尺长，最重的可达79吨。
中国渔政45001号	重	570吨	“中国渔政45001号”造于2001年，重570吨，长55米，是目前广西最大的渔政船。
春秋吴王夫差鉴	重	45公斤	春秋吴王夫差鉴为春秋晚期的青铜器。高45厘米，口径73厘米、重45公斤。
唐金银丝结条笼子	重	355克	唐金银丝结条笼子：通高15厘米，长14.5厘米，宽10.5厘米，重355克。
斯基罗斯壁蜥	重	6-7克	斯基罗斯壁蜥，是希腊斯基罗斯岛的特有物种，全长14厘米左右，重量6-7克。栖息在地中海环境下的灌木丛中，以昆虫为食，特别是节肢动物。斯基罗斯壁蜥是活跃的爬行动物，可以依靠快速爬行，摆脱天敌，也会主动脱落尾巴来迷惑敌人，借机逃生。
石羊孔庙	重	3吨	石羊孔庙位于大姚县城西面36公里的石羊镇，又称大姚孔子铜像，始建于明代，如今保留有大成殿、崇圣殿等古建筑群。其中，最引人注目的是大成殿内的孔子铜像，高2.3米，重约3吨，为各地文庙所罕见，这是当今现存的最大的孔子铜像。
白杨-M洲际弹道导弹	重	47吨	白杨-M洲际弹道导弹重47吨，长近23米，安装有固体燃料发动机，能以疯狂的速度拔地而起，可以摧毁1万公里以外的目标。
千斤拨	粗	1.2-2.5mm	千斤拨，多年生草本。茎直立或上升，有时具匍匐根茎，连花序高8-30cm，粗1.2-2.5mm，圆棱形，被白色具节长柔毛，基部多少木质化。
体验价值	即	产品价值	顾客感知价值由三个核心驱动要素构成，即产品价值、服务价值和体验价值。
吉穆	父	吉平	其父吉平为东汉太医。吉穆与耿纪，韦晃，金祎及其兄吉邈密谋杀曹操，后事泄被灭族。
卫璪	父	卫恒	卫璪（？―311年），字仲宝，卫瓘之孙，卫恒之子，西晋著名书法家。承袭祖父卫瓘的爵位兰陵公。后来东海王司马越把兰陵用于扩充自己的封国，改封卫璪为江夏郡公，食邑八千五百户。
乞伏元基	父	乞伏炽磐	乞伏元基，十六国时期西秦君主文昭王乞伏炽磐的长子。母不详。他曾被父亲派到后秦做人质。414年，乞伏炽磐灭南凉，复称秦王，元基从后秦的首都长安逃回，炽磐封其为尚书左仆射，后改封辅国将军、进封右丞相。
吴鸿锡	父	德佑	吴鸿锡，字允康，福建晋江人。父德佑，康熙初，客浙江，兵部郎中噶尼布奉命督造战舰，延德佑入幕。
冀鲁豫	冀	河北	冀鲁豫即河北省、山东省、河南省的简称。
俚岛避风港	楼	46栋	俚岛避风港位于山东威海，被称为中国江北第一线的荣成。项目总建筑面积18万平方米，46栋楼，2000户，一期16栋共计900多户。
制香附	性	性平	制香附，一种中药，味辛、微苦、甘，性平。
归云洞	深	12米	洞高16米，深12米。因春夏，常有云雾缭绕洞口，故名“归云洞”。诗云：“宋室江山云渺渺，归云洞外水悠悠。
托克帕拉铜矿	深	2300英尺	托克帕拉铜矿位于秘鲁南部安第斯山脉，宽1.5英里（约合2.4公里），深2300英尺（约合700米）。
玉印岩	深	11米	玉印岩洞深11米，宽15米，高10米。
紫檀西番莲炕桌	深	49.7cm	紫檀西番莲炕桌，规格：高32cm；宽84.5cm；深49.7cm。
河池六甲小山峡	深	约400米	六甲小山峡（姆洛甲女神峡）河池六甲小山峡地处金城江上游，精华地段由天门峡、凉风峡、龙门峡等组成，为典型的岩溶地型峡谷地貌，目前已开发的旅程往返12公里。景区的峡谷犹如被地壳运动撕开石峰后留下的一条大裂缝，宽100米左右，深约400米。
蛮子洞	深	约6米	蛮子洞乃是四川省遂宁市联盟乡一个叫“安国寺”的村子后山顶上的一个天然洞穴。洞高约2.5米，宽约3米，深约6米，洞低平坦，四面是石壁。
龙洞造像	深	约500米	龙洞造像及石刻位于历城县港沟镇龙洞山(亦称禹登山)。1992年被公布为第二批省级重点文物保护单位。山的西峰悬崖上有一天然喀斯特溶洞,高约2.7米,阔1.3米,深约500米,呈东西走向,传为神龙蛰居处,故名“龙洞”。
黄花梨乌木滚凳	深	28cm	这件黄花梨乌木滚凳，高17.7cm、宽7.7cm、深28cm。
鸭绿江大峡谷	深	170米	鸭绿江大峡谷，长10余公里，宽200多米，深170米。两侧悬崖绝壁如削，中间奇峰异石林立，两边谷壁的巨大石峰、石柱、石笋、石墙，如古堡耸立、石笋破土。两壁火山岩和火山碎屑，经数百年的风雨剥蚀，形成千姿百态的图案，向人间展示鸭绿江大峡谷壮丽奇观。
阿特湖	深	171米	阿特湖是萨尔茨卡默古特内最大的湖，也是奥地利境内最大的山区湖泊，长20公里，宽20至30公里，深171米。阿特湖为垂钓和各种水上运动如帆板、潜水、扬帆和滑水提供了很好的条件。
阿波丸号	深	12.6米	阿波丸号是一艘建造于20世纪40年代的日本远洋油轮，船长154.9米，宽20.2米，深12.6米，总吨位11249.4吨。1945年3月28日，已被日本军队征用的阿波丸号在新加坡装载了从东南亚一带撤退的大批日本人驶向日本。
龙井峡	深	400米	龙井峡，原名龙井河，是皖西最大的瀑布群。峡谷位于安徽省六安市霍山县境内大别山主峰白马尖东北侧，离白马尖主景区仅4公里。大峡谷长15公里，深400米，宽40-300米，峡谷内瀑布成群，怪石遍地，青山相对，雄伟壮观。
高弗·伯杰洞	深	3723英尺	高弗·伯杰洞（GouffreBerger）位于法国东南部格勒诺布尔市（Grenoble）附近，深达3723英尺，即1135米左右，是由一条地下暗泉冲刷岩石中的缝隙并使之慢慢变大而形成的。
妇女树	茎	长42厘米	妇女树它高约4米，茎长42厘米，没有花蕾，它的35朵花都是从“性器官”分娩出来的，就象动物繁殖后代一样。
明紫檀藤心矮圈椅	横	59厘米	明紫檀藤心矮圈椅，清宫旧藏，现藏于故宫博物馆。高58厘米，横59厘米，纵37厘米。
张果老见明皇图	横	107.3cm	《张果老见明皇图》卷，元，任仁发作，绢本，设色，纵41.5cm，横107.3cm。
张溥墓志铭	横	193.8厘米	张溥墓志铭是中国明代书法家黄道周楷书作品。此卷为纸本，楷书，纵28.7厘米，横193.8厘米。
明东西洋航海图	横	96厘米	《明东西洋航海图》，是一张纵158厘米、横96厘米，经牛津博德立安图书馆授权复制的原大绢本彩绘明代古地图，《明东西洋航海图》明确标有罗盘与比例尺，带有明显的西方现代制图理念，这张地图的出现，改写了中国地图史，是首张具有现实指导意义的中国古代航海总图。
明月种树图	横	86．5厘米	《明月种树图》是中国清代画家汤禄名的国画作品。该画为立轴，纸本设色，纵168．5厘米，横86．5厘米，台北故宫博物院藏。
晚景图	横	37.6厘米	《晚景图》轴是中国南宋佚名画家的国画作品。该画绢本墨笔，纵69.5厘米、横37.6厘米，现藏于上海博物馆。
大观园图	横	362cm	《大观园图》，纸本，设色，纵137cm，横362cm，是清无名氏画家根据清代著名作家曹雪芹创作的小说《红楼梦》创作的绘画作品。
平番得胜图	横	972.2厘米	明神宗万历年间/全卷纵43.8厘米、横972.2厘米/平番得胜图卷系由明初朱元璋外甥李文忠的后代保存，称“岐阳王世家文物”，是一卷描绘万历年间平定西北少数民族叛乱的历史画卷。
墨龙图	横	130.5厘米	《墨龙图》是南宋画家陈容的绘画精品,此图为双幅绢本，纵201.5厘米，横130.5厘米，墨笔。
春山秀色图	横	150.5厘米	《春山秀色图》是中国清代画家高俨的国画作品。该画为立轴，绢本设色，纵174.4厘米，横150.5厘米，现藏于广东省博物馆。
春溪归帆图	横	45厘米	《春溪归帆图》是中国清代画家罗牧的国画作品。该画为立轴，绢本水墨，纵186厘米，横45厘米，现流落于日本民间。
春山清霁图	横	102．5厘米	《春山清霁图》是中国元代画家马琬的国画作品。该画为纸本墨笔，纵27厘米，横102．5厘米，台北故宫博物院藏。
安道帖	横	35.5厘米	《安道帖》，蔡襄，尺牍，1055年，纸本，纵26.8厘米，横35.5厘米，台北故宫博物院藏。
圆明园长春园图	横	88cm	《圆明园长春园图 》，清乾隆五十一年（1786年）内府铜版刊本。册页装1函，图版20幅。纵50.7cm，横88cm。
岁寒三友图页	横	23.3厘米	岁寒三友图页，绢本墨笔纵24.3厘米、横23.3厘米赵孟坚系南宋末年的著名画家，著有《梅谱》。
春塘水暖	横	102厘米	《春塘水暖图》作于1961年，纵248.5厘米，横102厘米，是潘天寿大幅作品的代表作之一，也是藏于民间的潘天寿的最大作品。
幽谷清流图	横	22．1厘米	《幽谷清流图》是中国清代画家樊圻的国画作品。该画绢本设色，纵13．1厘米，横22．1厘米，上海博物馆藏。
幽谷茅庵图	横	22．1厘米	《幽谷茅庵图》是中国清代画家樊圻的国画作品。该画绢本设色，纵13．1厘米，横22．1厘米，上海博物馆藏。
清黄花梨月洞门架子床	横	247.5厘米	清黄花梨月洞门架子床，清宫旧藏高227厘米m，横247.5厘米，纵187.5厘米。
清袁耀露台秋月图	横	142.5	清袁耀露台秋月图，纵183、横142.5厘米，胡佩衡旧藏，该画绘中秋宫苑赏月情景，一轮明月当空，万籁俱寂，宫殿在树木中或露或隐，山石玲珑剔透，诗情画意跃然纸上，此意趣决非一般画匠所能为。
溪边隐士图	横	75.1厘米	戴进的《溪边隐士图》（见右图），绢本，水墨淡彩，纵137.9厘米，横75.1厘米，现藏美国克利夫兰美术馆。
殊竹图	横	29．9厘米	《殊竹图》是中国明代画家孙克弘的国画作品。该画为立轴，纸本设色，纵61．7厘米，横29．9厘米，台北故宫博物院藏。
水村图卷	横	120.5cm	《水村图卷》是元代画家赵孟頫的国画作品。此画现藏于故宫博物院，纸本，水墨，纵24.9cm，横120.5cm。
温其球莲花峰	横	46.4厘米	温其球莲花峰，纸本，纵36.1厘米、横46.4厘米。
绶带梅花长方花盆图样	横	122.5cm	《绶带梅花长方花盆图样》,纸本，墨笔，纵35cm，横122.5cm。
柘溪草堂图	横	79.8厘米	《柘溪草堂图》是中国清代国画吴宏的国画作品。该画为立轴，绢本设色，纵160.8厘米，横79.8厘米，现藏于南京博物馆。
白雪高风图	横	150．5厘米	《白雪高风图》是中国明代画家江必名的国画作品。该画为立轴，纸本，墨笔，纵299．6厘米，横150．5厘米，苏州市博物馆藏。
湖亭秋兴图	横	102厘米	《湖亭秋兴图》是中国清代画家黄慎的国画作品。该画为立轴，纸本设色，纵181厘米，横102厘米，现藏于南京博物馆黄慎，中国清代画家。
溪山楼阁图	横	20厘米	《溪山楼阁图》是中国清代画家刘度的国画作品。该画为册页，绢，设色，纵27厘米，横20厘米。
脚气帖	横	21.7厘米	《脚气帖》尺牍，约1060年，纸本，行草书，纵26.9厘米，横21.7厘米。
秋风扇图纨图	横	39.3厘米	秋风扇图纨图由明唐寅所作的纸本水墨，目前由上海博物馆藏，纵77.1厘米横39.3厘米，画家用遒劲飞舞的线条，表现了生动的形象，刻画了一位体态丰盈，举止安详，头部勾勒精工的富贵人家之少妇。
清陈鸿寿山水	横	36厘米	清陈鸿寿山水为清陈鸿寿的“山水”，纸本，纵44厘米，横36厘米。
牡丹兰桂花葫芦形瓶图样	横	35.5cm	《牡丹兰桂花葫芦形瓶图样》，纸本，设色，纵53.5cm，横35.5cm。
香满蒲塘图	横	47.5厘米	《香满蒲塘图》是中国清代画家胡公寿的国画作品。该画为立轴，纸本，设色，纵178.9厘米，横47.5厘米，上海博物馆藏。
高颈双耳活环花鸟花瓶图样	横	24.9cm	《高颈双耳活环花鸟花瓶图样》，纸本，设色，纵45.0cm，横24.9cm。
雪窗仕女图	横	62.5厘米	《雪窗仕女图》（清代叶道本）绢本，设色，纵121厘米，横62.5厘米。
雪景山水册页	横	31.8厘米	《雪景山水册页》是中国清代画家石涛的国画作品。该册页为纸本，墨淡色，纵48厘米，横31.8厘米，现流落于（美）堪萨斯市纳尔逊·艾京斯艺术博物馆。
葵花六角花盆图样	横	73.5cm	《葵花六角花盆图样》，纸本，设色，纵37.5cm，横73.5cm。
陛见帖	横	四零·八厘米	《陛见帖》，行书，纸本，纵二九·七厘米，横四零·八厘米。
芦雁图轴	横	50厘米	《芦雁图轴》有二，其一作者为清代李因，绫本水墨，纵149.5厘米，横50厘米，藏于上海博物馆。
西风木落图	横	43厘米	此为明谢时臣的“西风木落图”。纸本立轴。纵126厘米，横43厘米。
蛤蟆仙人图	横	70厘米	《蛤蟆仙人图》是中国清代画家闵贞的国画作品。该画为立轴，纸本设色，纵180．1厘米，横70厘米，现流落于日本民间。
长松羽士图	横	56厘米	《长松羽士图》该画尺寸，纵114厘米、横56厘米，纸本，墨笔绘成。
花阴犬吠图	横	37．8厘米	《花阴犬吠图》是中国清代画家任预的国画作品。该画为条屏，纸本，纵142．8厘米，横37．8厘米，南京博物院藏。
送四十九侄诗帖	横	130.3厘米	黄庭坚《送四十九侄诗帖》纸本，行楷书，纵35.2厘米，横130.3厘米，凡13行，每行4字，其中3行为两字，共46字。
霜柯竹石图	横	30．7厘米	《霜柯竹石图》是中国明代画家文徵明的国画作品。该画为立轴，纸本墨笔，纵76．9厘米，横30．7厘米，上海博物馆藏。
达摩图	横	53.1厘米	《达摩图》山中国明代画家吴彬第国画作品。该画为立轴，绢本，没色，纵118.8厘米，横53.1厘米，北京故宫博物院藏。
山谷雅居图	纵	28.3厘米	《山谷雅居图》是中国清代画家普荷的国画作品。该画为册页，洒金笺，纸本，水墨，纵28.3厘米，横28.6厘米，四川省博物馆藏。
松溪论画图	纵	60厘米	《松溪论画图》作者：仇英《松溪论画图》是中国明代画家仇英的国画作品。该画为绢本设色，纵60厘米，横105厘米，吉林省博物馆藏。
清奚冈华岳题名记	纵	26.5厘米	清奚冈华岳题名记，16页，纸本，纵26.5厘米、横18.5厘米。
高士观瀑图	纵	178厘米	【名称】明钟钦礼高士观瀑图【简介】立轴，绢木，水墨，淡设色，纵178厘米，横104厘米。
最新大中华帝国道县形势全图	纵	26厘米	这本图册为土黄色素皮封面，每页纸本纵26厘米，横18厘米，图册为手写手绘，套色石印。其中有98幅图页，每幅图页上方均注明了该幅地图的行政区划名称，封底内页写有“中华洪宪元年元月二十六日”等字样，“最新大中华帝国道县形势全图”“北京同伦学社印行”等字样。
平定西域献俘礼图	纵	42厘米	平定西域献俘礼图：手卷。为设色纸本，纵42厘米，横1800厘米。
寿桃鹦鹉花盆图样	纵	44.6cm	《寿桃鹦鹉花盆图样》，纸本，设色，纵44.6cm，横136.8cm。
秋瓜图	纵	63.1厘米	《秋瓜图》纸本设色纵63.1厘米横30厘米。
红绿梅花图	纵	138厘米	《红绿梅花图》是中国清代画家金农的国画作品。该画为立轴，绢本，设色，纵138厘米，横65.5厘米，上海博物馆藏。
干呕帖	纵	14.1厘米	《干呕帖》，又名《如常帖》、《昨还帖》。纵14.1厘米，横26.4厘米，共4行36个字，五代至北宋时期的临摹本。
松壑云泉图	纵	141厘米	《松壑云泉图》是中国明代画家宋旭的国画作品。该画为立轴，绢本设色，纵141厘米，横63厘米，山东省博物馆藏。
溪桥深翠图	纵	31.5厘米	《溪桥深翠图》是中国清代画家方琮的国画作品。该画为长卷，纸本设色，纵31.5厘米，横135厘米，收藏于广东省博物馆。
幽居图	纵	27厘米	《幽居图》纸本，纵27厘米，横115.9厘米，青绿设色。
清闷阁墨竹图	纵	132.8厘米	《清闷阁墨竹图》是中国元代画家柯九思的国画作品。该画为立轴，纸本，墨笔，纵132.8厘米，横58.5厘米，北京故宫博物院藏。
骷髅幻戏图页	纵	27厘米	《骷髅幻戏图页》是中国南宋画家李嵩的国画作品。该画现藏于故宫博物院，绢本设色，纵27厘米，横26.3厘米。
游骑图	纵	22.7厘米	《游骑图》，唐，佚名，绢本设色，纵22.7厘米，横94.8厘米。
牡丹芙蓉花鱼缸图样	纵	45.8cm	《牡丹芙蓉花鱼缸图样》，纸本，设色，纵45.8cm，横70.3cm。
寒塘凫侣图页	纵	16.6cm	南宋寒塘凫侣图页绢本，设色，纵16.6cm，横20.8cm。
春夜宴桃李园图甲	纵	17．5厘米	《春夜宴桃李园图甲》是中国明代画家盛茂烨的国画作品。该画为扇面，纸本，水墨，淡设色，纵17．5厘米，横55厘米，现流落于日本民间。
寒岩积雪	纵	130厘米	此为明蓝瑛的“寒岩积雪”。纸本，立轴，纵130厘米，横62厘米。
门屏帖	纵	27.8厘米	《门屏帖》尺牍，纸本，纵27.8厘米，横16厘米。
立马图	纵	47.3cm	《立马图》轴，清道光，奕詝绘，纸本，设色，纵47.3cm，横23.4cm。
深山访友图	纵	206．3厘米	《深山访友图》是中国明代画家王世昌的国画作品。该画为立轴绢本，水墨淡设色，纵206．3厘米，横114．5厘米，现流落于（美）耶鲁大学美术馆藏。
清杨守敬行书中堂	纵	244厘米	清杨守敬行书中堂轴纸本，纵244厘米、横117厘米，藏湖北省博物馆藏。
高士观景图	纵	34．5厘米	《高士观景图》是中国明代画家文嘉的国画作品，描写了一高士于舟中仰观云山景色的情景，册页纸本，墨笔，纵34．5厘米，横41．5厘米，现藏于广东省博物馆。
梅花圆花盆图样	纵	40cm	《梅花圆花盆图样》，纸本，设色，纵40cm，横27.8cm。
幽亭老树图	纵	131．6厘米	《幽亭老树图》是中国明代画家程嘉燧的国画作品。该画为立轴，纸本墨笔，纵131．6厘米，横272厘米，北京故宫博物院藏。
牧牛图	纵	60厘米	《牧牛图》，北朝佚名壁画，纵60厘米，横33厘米。《牧牛图》画面用勾线法，线条质朴、沉着、劲健，色彩平涂。《牧牛图》也是重庆市大足县宝顶山石刻中的一组著名石刻图。
西湖图卷	纵	26.7厘米	《西湖图卷》是中国宋代画家李嵩的国画作品。该画纸本墨笔纵26.7厘米、横85厘米。
设色牡丹草虫图轴	纵	110.9厘米	清居廉《设色牡丹草虫图轴》，绢本，纵110.9厘米，横42.1厘米。
明董其昌青弁图	纵	225厘米	明董其昌青弁图立：轴，纸本，水墨，纵225厘米，横66．88厘米。
缂丝凤穿牡丹图	纵	66.8厘米	缂丝凤穿牡丹图宋纵66.8厘米宽36.7厘米画面采用图案式体裁，富有装饰意趣。
清董邦达仿元人小景图轴	纵	49厘米	清董邦达仿元人小景图轴，此轴画于金笺上，纵49厘米、横31厘米，上海人民美术出版社藏。
浅绛山水图	纵	125厘米	此轴为黄宾虹的“浅绛山水图”，设色纸本，纵125厘米，横31厘米，藏于西泠印社。
童子牧牛图	纵	60厘米	此为李可染的“童子牧牛图”。纸本，立轴，纵60厘米，横37厘米。
幽谷村落图	纵	13．1厘米	《幽谷村落图》是中国清代画家樊圻的国画作品。该画绢本设色，纵13．1厘米，横22．1厘米，上海博物馆藏。
幽兰图	纵	110.3厘米	《幽兰图》是中国明代画家杜大绶的国画作品。该画为纸本设色，纵110.3厘米，横30.8厘米，南京博物馆藏。
潇湘卧游图卷	纵	30.2厘米	《潇湘卧游图》，纸本墨笔，纵30.2厘米，横399.4厘米，卷首有乾隆皇帝御题“气吞云梦”四字。乾隆帝又于卷中两处分别题有一跋一诗，题咏不足，又在卷尾画了一丛竹子并有款识。《潇湘卧游图卷》的价值甚至在《溪山行旅图》和《富春山居图》之上。
洒线绣蜀葵荷花五毒纹经皮面	纵	30cm	洒线绣蜀葵荷花五毒纹经皮面，明，纵30cm，横27cm。
溪桥幽兴图	纵	63．3厘米	《溪桥幽兴图》是中国画家方从义的国画作品。该画为立轴，纸本墨笔纵63．3厘米，横35厘米，北京故宫博物院藏。
校官碑	纵	148厘米	全称《汉溧阳长潘乾校官碑》，碑额题为《校官之碑》，简称《校官碑》或《潘乾碑》。纵148厘米，横76厘米，厚22．5厘米，16行，行27字。
碧桃春鸟图	纵	110.3厘米	《碧桃春鸟图》是中国明代画家凌必正的国画作品。该画为立轴绢本设色，纵110.3厘米，横53.3厘米，上海博物馆藏。
晴川揽胜图	纵	112厘米	此为清恽寿平的《晴川揽胜图》，绫本设色，纵112厘米，横39．1厘米，现藏辽宁省博物馆。
行书题刘松岚明府湘花图卷诗轴	纵	129厘米	清王文治行书题刘松岚明府湘花图卷诗轴纸本纵129厘米横44.4厘米。
清中期牙雕三阳开泰图插	纵	46.6厘米	这件清中期牙雕三阳开泰图插屏，通高60厘米，屏心纵46.6厘米，横33.8厘米。
水竹图	纵	87．1厘米	《水竹图》是中国元代画家管道升的国画作品。该画为立轴，纸本墨笔，纵87．1厘米，横28．7厘米，中国台北故宫博物院藏。
骏骨图	纵	29.9厘米	《骏骨图》是中国宋代画家龚开的国画作品。该画纵29.9厘米，横56.9厘米，现流落于日本大阪市立美术馆。
洞庭东山图	纵	61.9厘米	洞庭东山图，元代赵孟頫作品，绢本，设色纵61.9厘米，横27.6厘米。
重林复嶂图	纵	91.3厘米	《重林复嶂图》是中国清代画家王昱的国画作品。该画为立轴，纸本设色，纵91.3厘米，横51.8厘米，现藏于上海博物馆。
水仙茶梅图	纵	118.3厘米	《水仙茶梅图》是中国清代画家姜泓的国画作品。该画为立轴，绢本，设色，纵118.3厘米，横42.9厘米，南京博物院藏。
曹悼公	姓	姬姓	曹悼公（？―公前515年)，姬姓，曹氏，名午，春秋时期曹国国君。
彩石溪	辖	桃花源	彩石溪景区位于泰山西麓，辖桃花峪、桃花源两个景区，面积1173公顷，森林覆盖率达85%以上，素有““泰山森林博物馆”、“泰山小江南”、“北方小九寨”之美誉，是泰山休闲观光胜地。
岳普湖镇	辖	3个村委会	岳普湖镇，位于岳普湖县县城周边，东、南（部分地区与县林场接壤）、西、北均在岳普湖乡范围内，辖5个社区、3个村委会。
朗公庙	辖	30个行政村	新乡县朗公庙镇位于新乡市南10公里，107国道“日月同辉”标志处，东邻关堤乡、古固寨镇，南与原阳县接壤，西毗七里营镇，北靠新乡市高新技术产业开发区。全镇51770人，61800亩耕地，总面积80.2平方公里，辖30个行政村，28个自然村。
航海西路街道	辖	密垌	航海西路街道位于河南省郑州市中原区西南城乡结合部。辖小岗刘、冯湾、段庄、道李、郭厂、石羊寺、闫垌、密垌、后河卢、李江沟10个行政村，32个自然村，62个村民小组。
黎博寨工作站	辖	19个行政村	黎博寨工作站位于临西县东南部，是著名的林果之乡、养殖大乡。总面积35.6平方公里。辖19个行政村，含19个自然村。
西场	辖	11个行政村	江苏省南通市海安县西场镇，古称蓉塘，位于海安县城东12公里处，拼茶运河、202省道穿镇而过。全镇总面积55.4平方公里，辖2个居委会，11个行政村，241个村民小组，总人口50752人。
撼庭竹	调	仄韵两体	《撼庭竹》，词牌名，此调有平韵、仄韵两体。
狒狒	组	狭鼻组	灵长目猿猴亚目狭鼻组猴科的1属，通称狒狒。是灵长类中次于猩猩的大型猴类，共分为五种，都分布于非洲地区。过去的分类法把狮尾狒也归入狒狒属，现在已单独列为一属。
盾果藻	类	海水藻类植物	盾果藻为海膜科、盾果藻属海水藻类植物，藻体直立，丛生，线形，基部具不规则盘状固着器。
