宅的表现是不出门。	宅
冷笑话可能不好笑。	冷
告白成功可能会笑。	笑
狗的特点是忠心。	狗
冷可能导致感冒。	冷
胖可能因为懒惰。	胖
猫可能会撒娇。	猫
叫的表现是有声音。	叫
饿可能因为没吃饭。	饿
渴可能因为没喝水。	渴
冷的表现是温度低。	冷
晕可能因为缺氧。	晕
饿表现为肚子咕咕叫。	饿
吐可能因为肠胃发炎。	吐
吐可能因为肠胃炎。	吐
笑可能因为被呵痒。	笑
吐可能因为觉得恶心。	吐
买东西的时候，你会付钱。	买
买东西的时候，你会刷卡。	买
买东西的时候，你会去付钱。	买
买东西的时候，你会带钱包。	买
悲伤的时候，你会哭。	哭
睡的时候，你会打呼。	睡
喝饮料的时候，你会找吸管。	喝
喝饮料的时候，你会拿吸管。	喝
喝水的时候，你会拿杯子。	喝
买东西的时候，你会拿出钱包。	买
买东西的时候，你会掏钱。	买
买东西的时候，你会杀价。	买
睡的时候，你会做梦。	睡
睡的时候，你可能会梦游。	睡
饿的时候，你会泡泡面吃。	饿
渴的时候，你会泡茶喝。	渴
笑的时候，你会露出牙齿。	笑
饿的时候，你会煮东西吃。	饿
买东西的时候，你会用到MONEY。	买
买东西的时候，你会用到钱。	买
喝饮料的时候，你会用吸管。	喝
冷的时候，你会用暖宝宝。	冷
喝粥的时候，你会用碗。	喝
买东西的时候，你会看制造日期。	买
买东西的时候，你会精打细算。	买
钱包空空是买东西造成的。	买
你会闭眼睛睡。	睡
你会闭着眼睛睡。	睡
笑的时候，你的脸上会出现鱼尾纹。	笑
中乐透的时候，你觉得很爽。	爽
中枪的时候，你会感觉痛。	痛
你兴奋的时候会跳起来。	跳
吃冰块的时候，你会感觉冷。	冷
吃口香糖的时候，你会嚼口香糖。	嚼
饿的时候，可能会吃宵夜。	饿
如果吃很多东西，你会胖。	胖
吃面的时候，你会用嘴吸面条。	吸
吃苹果的时候，你会用牙咬苹果。	咬
吃饱的时候，你会感到肚子撑。	撑
你感到热的时候可能会吹电扇。	热
肚子咕咕叫可能代表饿。	饿
哈士奇是一种狗。	狗
在沙漠里你会感到热。	热
由于胖，你会克制饮食。	胖
由于胖，你会减肥。	胖
饿的时候，你会吃便当。	饿
饿的时候，你会吃包子。	饿
由于胖，你会少吃点。	胖
哭的时候，你会掉眼泪。	哭
你的眼泪会流在脸上。	脸
你会走在路上。	路
你会躺在家中的床上。	家
在不开心时，你可能会哭。	哭
在伤心时，你可能会哭。	哭
在便利商店，你可能会买东西。	买
你会在儿童乐园里玩。	玩
在北极，你会感到冷。	冷
在单身派对，你会感觉很爽。	爽
在南极，你会感到冷。	冷
在厨房，你会感到热。	热
在吃冰，你会感觉很爽。	爽
在夏天，你会感到热。	热
在大便时，你会感觉很爽。	爽
在太阳上，你会感到热。	热
在放屁时，你会感到爽。	爽
在淹水时，你会往下沉。	沉
在滑倒时，你会感到痛。	痛
在生理期时，你会感到痛。	痛
在电影院，你会看电影。	看
在老妈生气时，你会变乖。	乖
大便的时候，你会感到臭。	臭
天黑的表现是暗。	暗
打电话的时候，你会说喂。	喂
拿起话筒的时候，你会说喂。	喂
有人放屁可能有臭味。	臭
热的时候会流汗。	热
淋雨的时候，你会感到冷。	冷
看到废文的时候，你会发出嘘声。	嘘
考一百分的时候，你会感到爽。	爽
被电到的时候，你会感到麻。	麻
跌倒可能会痛。	痛
飞上天的时候，你会感到爽。	爽
钱在保管箱里。	钱
书夹在腋下。	书
人有失足的时候。	人
家里安全。	家
人有悲伤的情绪。	人
山里有森林。	山
水由氢原子和氧原子组成。	水
海里有珊瑚。	海
书里有色情。	书
海里有螃蟹。	海
床上有被单。	床
家是避风港。	家
海里有鲨鱼。	海
你可以在店里找到xo酱。	店
你可以在店里找到亲子丼。	店
你可以在树上找到叶子。	树
你可以在海里找到大白鲨。	海
你可以在河里找到小水草。	河
你可以在河里找到小石子。	河
你可以在脚上找到指甲。	脚
你可以在家里找到指甲剪。	家
你可以在树上找到昆虫。	树
你可以在树上找到果实。	树
你可以在路边找到树木。	路
你可以在海里找到沙丁鱼。	海
你可以在海里找到鲨鱼。	海
你可以在海里找到浮游生物。	海
你可以在海里找到热带鱼。	海
你可以在天上找到白云。	天
你可以在庙里找到神像。	庙
你可以在庙里找到纸钱。	庙
你可以在腿上找到肌肉。	腿
你可以在田里找到花生。	田
你可以在庙里找到香灰。	庙
你可以在庙里找到香炉。	庙
你可以在兔子身上找到毛。	毛
你可以在包子里找到肉。	肉
你可以在吉他上找到弦。	弦
你可以在周星驰电影里找到梗。	梗
你可以在坟墓里找到鬼。	鬼
你可以在培根里看到油。	油
你可以在天上找到云。	云
你可以在奖状上找到字。	字
你可以在小提琴上找到弦。	弦
你可以在小鸡身上找到喙。	喙
你可以在尸体上找到蛆。	蛆
你可以在庙里找到香。	香
你可以在康熙中找到梗。	梗
你可以在捐血活动中看到针。	针
你可以在柠檬里找到籽。	籽
你可以在洗手台看到水。	水
你可以在洗手间看到水。	水
你可以在浴室看到水。	水
你可以在狼牙棒上找到刺。	刺
你可以在胡椒饼里找到肉。	肉
你可以在腐烂的食物里找到蛆。	蛆
你可以在自助餐里找到菜。	菜
你可以在视讯里看到人。	人
你可以在酱料里找到醋。	醋
你可以通过门牌号码找到家。	家
墙上有画。	画
大气层在天上。	天
太阳在天上。	天
山上有草。	草
工作就会有钱。	钱
建议售价在书后。	书
在户外开车。	户
抽筋很痛。	痛
拉屎有臭味。	臭
拖鞋穿在脚上。	脚
木星在天上。	天
松鼠住在树上。	树
水母在海里。	海
汽车是铁做的。	铁
烟灰缸在桌上。	桌
滑梯在户外。	户
在野外狩猎。	野
秋千在户外。	户
在家里睡觉。	家
肚子上有肉。	肉
袜子在脚上。	脚
在郊外踏青。	郊
在郊外野餐。	郊
铁达尼是船。	船
云在天上。	天
鸟巢在树上。	树
猫喜欢喵喵叫。	猫
猫很慵懒。	猫
猫总是懒洋洋的。	猫
车需要汽油。	车
球会滚动。	球
书需要被好好保存。	书
狗被喜欢被主人摸头。	狗
鸟会飞。	鸟
鸟会飞行。	鸟
猫喜欢捉老鼠。	猫
狗惧怕被主人遗弃。	狗
狗可能会乱吠。	狗
猫可能会发情。	猫
猫喜欢吃鱼。	猫
狗会吠。	狗
狗会吠叫。	狗
狗喜欢啃骨头。	狗
猫会喵喵叫。	猫
钱会被存在银行。	钱
猫喜欢玩毛线球。	猫
开店时希望生意兴隆。	店
鸟会筑巢。	鸟
鸡会下蛋。	鸡
人会想要赚钱。	钱
钱会被花掉。	钱
买东西需要钱。	钱
买手机需要钱。	钱
买水果需要钱。	钱
买点数需要钱。	钱
买电脑需要钱。	钱
买鸡饲料需要钱。	钱
交女朋友需要钱。	钱
做生意想要钱。	钱
做生意的人想要钱。	钱
偶像想要变红。	红
分手时会哭。	哭
吃安眠药时会更容易睡。	睡
啄木鸟喜欢吃虫。	虫
四川难民惧怕地震。	震
失恋会哭。	哭
头皮会痒。	痒
小偷想要偷钱。	钱
小鱼需要水。	水
开心时可能想要笑。	笑
开心的时候可能喜欢笑。	笑
猫喜欢抓老鼠。	猫
李白喜欢写诗。	诗
汽油桶遇到火会爆炸。	火
流汗时想要喝水。	喝
海鸥会飞。	飞
游子想要回家。	家
想要看电影。	看
疲倦的人想要睡。	睡
疲劳的时候想要睡。	睡
痛苦的时候想要哭。	哭
眼皮会跳。	跳
累的时候想要睡。	睡
缺水想要喝水。	喝
诈骗集团想要骗钱。	钱
被责骂时可能会哭。	哭
赌博是想要赢钱。	钱
赌徒想要赢钱。	钱
赌鬼想要赢钱。	钱
跑路需要钱。	钱
逛街想要买东西。	买
狗喜欢吃骨头。	狗
高兴时可能想要笑。	笑
鱼儿生存需要水。	水
鸟儿喜欢吃虫。	虫
纸可以用来写信。	纸
画可以拿来装饰墙壁。	画
水可以汇聚成小河。	水
水可以汇聚成小溪。	水
教科书是用纸做的。	纸
云像棉花糖。	云
做甜品一定需要糖。	糖
书中有知识。	书
笔记本是用纸做的。	纸
考卷是用纸做的。	纸
讲义稿件是用纸做的。	纸
米可以拿来做成麻薯。	米
水由O离子和H离子构成。	水
书可以用一叠纸制成。	书
下雨带来水。	水
水由一个O离子和两个H离子构成。	水
猫有九条命。	猫
雨在云朵中形成。	雨
冰会融化成水。	水
书可以印刷制成。	书
榻榻米是一种床。	床
书中有学问。	书
蛋会孵出小鸡。	蛋
船上有帆。	船
书中有很多字。	书
抗生素是一种药。	药
书中有很多文字。	书
书中有智慧。	书
木柴燃烧产生火。	火
母鸡会下蛋。	蛋
蛇有毒液。	蛇
雨由下落的水滴组成。	雨
河由水组成。	水
眼泪由水组成。	水
海由水组成。	水
湖由水组成。	水
雨由热空气液化产生。	雨
书中有理论知识。	书
瓦斯炉燃烧产生火。	火
眼中有瞳孔。	眼
米可以用稻子制成。	米
蒸汽可以液化成水。	水
水可以被蒸馏。	水
冰融化成水。	水
衣服可以由布制成。	布
酸碱反应生成水。	水
钻木可以产生火。	火
阿司匹林是一种药。	药
雨由水形成。	水
雾由水形成。	水
水由两个O离子和一个H离子构成。	水
水的分子式是H₂O 。	水
人字由一撇一捺组成。	人
冰块会化成水。	水
云由冰晶和小水滴组成。	云
书由出版社出版。	书
书由印刷厂制造。	书
可燃物会引起火。	火
字由墨水写成。	字
好茶离不开好的泉水。	茶
风由对流形成。	风
狗这种动物代表忠诚。	狗
易燃物会引起火。	火
人这种生物有智慧。	人
纸由树木磨成浆制成。	纸
风由气压差形成。	风
水可以由氢气和氧气制成。	水
海可以容纳百川。	海
树干由维管束组成。	树
雾气由水形成。	水
树由韧皮部组成。	树
风由空气运动形成。	风
盐的主要化学原料是氯化钠。	盐
盐主要提取自海。	盐
交个人综合所得税需要钱。	钱
云朵由水和冰晶组成。	水
人体中含有大量的水。	水
交保险费需要钱。	钱
冰沙由水制成。	水
冰雪由水形成。	水
大学由院和系组成。	系
太阳能可以用来发电。	电
太阳能由光产生。	光
女人的身体含有很多水。	水
小抄一般写在纸上。	纸
小说写在书中。	书
居留证的材质是纸。	纸
布偶可以用线缝制。	线
幸福由心产生。	心
彩券的材质是纸。	纸
雨后可能有彩虹。	雨
想念由心产生。	心
感情由心产生。	心
房屋可以用砖砌成。	砖
护照的材质是纸。	纸
拜拜可以用手完成。	手
权力常常意味着有钱。	钱
水分子由氧元素和氢元素组成。	氧
水晶的主要化学成分是硅。	硅
水果大多长在树上。	树
法拉利是用钱买来的。	钱
泡面需要水。	水
海洋由水组成。	水
瀑布由水组成。	水
火柴主要由磷制成。	磷
爱心捐款需要钱。	钱
理财需要钱。	钱
交电费需要钱。	钱
睡觉离不开床。	床
红烧狮子头可以用猪肉制成。	肉
交综合所得税需要钱。	钱
考卷是用纸制成的。	纸
背包是用布制成的。	布
用盐来腌萝卜。	盐
用盐来腌黄瓜。	盐
花瓶可以用土烧制而成。	土
荷包可以用布制成。	布
菜刀的材质是钢。	钢
蔚蓝的海里有海水。	水
蛋包饭里的主食是米。	米
衣架的材质是铁。	铁
西瓜刀的材质是铁。	铁
课本由纸装订成册。	纸
貂皮大衣是用貂的毛制成。	毛
钱是财富的象征。	钱
人体主要由水构成。	水
车票的材质是纸。	纸
酱油可以拿来做菜调味。	菜
醋酸由米酿制而成。	米
金刚石是由碳元素构成的。	碳
金融的本质是钱的融通。	钱
钥匙可以用铁制成。	铁
钻石戒指的主要成分是碳元素。	碳
钻石的主要成分是碳元素。	碳
雨滴是水的一种形态。	水
餐券是用纸制作而成的。	纸
马克杯是用瓷制成的。	瓷
魔戒是用银制成的。	银
鱼网用绳编织而成。	绳
虫可以用来做鱼饵。	虫
饿的时候会吃东西。	饿
狗因为喜欢会摇尾巴。	狗
狗饿了会找骨头吃。	狗
家是可以带来温暖的地方。	家
水可以灌溉植物。	水
看悲剧的时候会哭。	哭
书中蕴藏着知识。	书
钱是用来花的。	钱
水是用来喝的。	水
车可以让人行动方便。	车
路的作用是联络交通。	路
路的作用是通行。	路
伞可以用来遮阳光。	伞
伞可以用来遮雨。	伞
狗见到陌生人会叫。	狗
饿的时候会想去餐厅。	饿
饿的时候会想要下馆子。	饿
累的时候会希望快点下班。	累
穷的时候会让自己别乱买东西。	穷
累的时候不想要说话。	累
睡的时候会做梦。	睡
睡前会关灯。	睡
饿的时候会想要猛吃。	饿
笑的时候会发出哈哈的声音。	笑
感觉苦的时候会想要吃甜的。	苦
累的时候会想呼呼大睡。	累
屋里臭的时候会想要喷芳香剂。	臭
困的时候会想要回床上睡觉。	困
玩的时候会有好心情。	玩
累的时候会想要到床上睡觉。	累
脏的时候会想要打扫卫生。	脏
渴的时候会想要找饮水机。	渴
渴的时候会想要找水喝。	渴
饿的时候会想要找泡面吃。	饿
烦的时候会很抓狂。	烦
地面脏的时候会想要拖地。	脏
累的时候会想要有人搥背。	累
热的时候会想要扇扇子。	热
累的时候会想要睡觉。	累
穷的时候会想薪水怎么还没发。	穷
累的时候会想要有人按摩。	累
玩的时候会非常开心。	玩
饿的时候会想要吃食物。	饿
饿的时候会想要吃馒头。	饿
买新鞋穿。	穿
买苹果吃。	吃
买菜吃。	吃
东西坏掉的时候会想要换新的。	换
作弊是为了顺利过考试。	过
不爱出门是你宅的表现。	宅
不知所措是你囧的表现。	囧
不赚钱的话，你会穷。	穷
不运动的话，你会胖。	胖
你和爱人分手的时候可能会哭。	哭
你会感觉很爽因为你中六合彩。	爽
如果久未进食，你会饿。	饿
你会感觉很爽因为你乐透中头彩。	爽
吃柠檬你会感觉很酸。	酸
喝了酒你可能会醉。	醉
夏天到了，你会感觉热。	热
如果太感动了，你会哭。	哭
如果你失恋了，你可能会哭。	哭
失血过多的话，你会死。	死
吐是害喜的一种表现。	吐
你会哭因为你心里不好受。	哭
你会笑因为你感觉愉快。	笑
你会笑因为你感觉愉悦。	笑
晕车的话，你可能会吐。	吐
你会感觉热因为气温过高。	热
没休息的话，你会累。	累
没吃东西的话，你会饿。	饿
没吃早餐的话，你会饿。	饿
没吃晚餐的话，你会饿。	饿
没吃饭的话，你会饿。	饿
没喝水的话，你会渴。	渴
没开冷气的话，你会热。	热
没睡觉的话，你会累。	累
如果消化完了，你会饿。	饿
你会喝水因为你渴。	喝
你会感觉痒因为你有牛皮癣。	痒
你会哭因为你的猫过世。	哭
你会哭因为你感觉痛苦。	哭
你会感觉痒因为你有皮肤病。	痒
当你在看喜剧时，你会笑。	笑
你会哭因为你不忍离别。	哭
你会想睡因为你累了。	睡
饿的时候，你肚子空空。	饿
被惹恼的话，你会发怒。	怒
如果想越过坑洞，你要跳。	跳
运动过后，你会感觉热。	热
你会变胖因为你都不运动。	胖
你会饿因为你闻到食物的香味。	饿
你的脚会痒因为你患有香港脚。	痒
你会累因为你骑车骑太久。	累
你会去整型因为你认为你丑。	丑
你的肚子会咕噜咕噜叫因为你饿。	饿
你会大笑因为你感觉很爽。	爽
你会引吭高歌因为你感觉很爽。	爽
你会胖因为你爱吃。	胖
因为累你会犯困。	累
你会自嗨因为你感觉很爽。	爽
你会高兴因为你感觉很爽。	爽
出生的时候会哭。	哭
去美国闯荡是为了钱。	钱
变成丑角是为了让别人笑。	笑
吃土司是为了让自己感到饱。	饱
嚎啕是哭的表现。	哭
害怕的时候会抖。	抖
当你想要买东西的时候你可能会上网拍。	买
当你出去玩的时候你可能会笑。	笑
当你哭的时候你可能会揉眼睛。	哭
当你哭的时候你可能会哽咽。	哭
当你想要飞到月亮上的时候你可能会学嫦娥吃药。	飞
当你想要哭的时候你可能会忧郁。	哭
当你想要钱的时候你可能会找临时工做。	钱
当你想要买东西的时候你可能会找最便宜的。	买
当你找朋友聊天时你可能会笑。	笑
当你想要哭的时候你可能会找朋友聊天。	哭
当你想要钱的时候你可能会做长工。	钱
当你想要买东西的时候你可能会拿钱。	买
当你哭的时候你可能会掉眼泪。	哭
当你哭的时候你可能会擦拭眼泪。	哭
当你想要买东西的时候你可能会比价。	买
当你泡泡面的时候你可能会想要水。	水
当你泡茶时你可能会想要水。	水
当你想要吃饭的时候你可能会洗米。	饭
当你哭的时候你可能会流眼泪。	哭
当你哭的时候你可能会热泪盈眶。	哭
当你想要买东西的时候你可能会看价钱。	买
当你想要哭的时候你可能会看喜剧片。	哭
当你想要哭的时候你的眼泪可能会打转。	哭
当你想要哭的时候你可能会自己一个人呆着。	哭
当你想要做一件事的时候你可能会评估它的风险。	做
当你向前冲的时候你可能会跌倒。	冲
当你想要买东西的时候你可能会逛街。	买
当你哭的时候你可能会闭眼睛。	哭
当你想要哭的时候可能因为难过。	哭
买了面包后，你可能会吃。	吃
因为饿，所以你会想要买面。	饿
当你想要买饭的时候你可能因为饿。	饿
当你想要买鸡腿的时候你可能因为饿。	饿
当你想喊人的时候你可能会叫。	叫
当你想要准备用餐具的时候你可能会洗餐具。	洗
当你想要动嘴巴的时候你可能要吃。	吃
当你想要宠物的时候你可能会买。	买
当你想要回家却回不去的时候你可能会哭。	哭
当你终于得奖的时候你可能会哭。	哭
当你想要拉棉被的时候说明你冷。	冷
当你流泪的时候你可能在哭。	哭
当你温习功课的时候你可能会累。	累
当你想要煮饭的时候你可能因为饿。	饿
当你想要打电动的时候你可能会玩。	玩
当你想要盖棉被的时候说明你冷。	冷
当你想要盖被子的时候说明你冷。	冷
当你想要睡觉时的时候说明你困了。	困
当你说梦话的时候你可能会笑。	笑
当你想要饭的时候你可能因为饿。	饿
想我的时候别人会想要哭。	哭
想要有钱应该要买乐透。	钱
想要有钱应该要争取晋升机会。	钱
想要有闲工夫应该要休假。	闲
想要有钱应该要做理财规划。	钱
想要变美应该要化妆。	美
想要有钱应该要去提款机取。	钱
想要有钱应该要去银行取。	钱
想要有钱应该要多找一份工打。	钱
想要变瘦应该要多运动。	瘦
想要有钱应该要做家教。	钱
想要变瘦应该要少吃。	瘦
想要有钱应该要发展人脉。	钱
想要存钱应该要慢慢花。	钱
想要变瘦应该要慢跑。	瘦
想要变瘦应该要戒宵夜。	瘦
想要变帅应该要打扮时尚。	帅
想要有钱应该要打工。	钱
想要喝酒应该要找朋友。	酒
想要有钱应该要有投资观念。	钱
企业想要赚钱应该要有企业创意力。	钱
企业想要赚钱应该要有企业道德。	钱
想要有钱应该要有权势。	钱
想要开车应该要有驾照。	车
有车的人应该熟悉交通规则。	车
想要有钱应该要省着吃。	钱
想要有钱应该要省着用。	钱
想要有钱应该要给父母存着。	钱
想要开车应该要考到驾照。	车
想要开车应该要考驾照。	车
想要有钱应该要懂得收放自如。	钱
想要有钱应该要付出。	钱
想要有闲工夫应该要规划时间。	闲
想要有钱应该要记账。	钱
想要有闲工夫应该要请假。	闲
想要变瘦应该要运动。	瘦
想要不无聊应该玩。	玩
想要乐观应该笑。	笑
想要有钱应该要赚。	赚
想要有名牌包应该要有钱。	钱
想要有宝徕应该要有钱。	钱
想要有宝徕毫宅应该要有钱。	钱
想要有小狼狗应该要有钱。	钱
想要有弹珠超人应该要有钱。	钱
想到有很多朋友应该要笑。	笑
想要有汽车应该要有钱。	钱
想要有漂亮的屋子应该要有钱。	钱
想要有猫应该要有钱。	钱
想要玩应该要有钱。	钱
想要有珠宝应该要有钱。	钱
想要睡觉应该要有床。	床
想要结婚应该要有钱。	钱
想要有老婆应该要有钱。	钱
想要有豪宅应该要有钱。	钱
想要有车应该要有钱。	钱
想要有风扇应该要有钱。	钱
想要有马子应该要有钱。	钱
想要死的时候会想跳楼。	死
打针疼的时候会想要哭。	哭
抠脚趾是因为痒。	痒
遇到挫折的时候会想要哭。	哭
攻城的时候会向前冲。	冲
买果汁是为了喝。	喝
潮是有格调的表现。	潮
削水果是为了吃。	吃
买照烧嫩鸡是为了吃。	吃
困的时候会想要睡。	睡
玩游戏是为了获得爽的感觉。	爽
玩电动是为了获得爽的感觉。	爽
玩电脑是为了获得爽的感觉。	爽
生孩子疼的时候会想要哭。	哭
看小说感动的时候会想要哭。	哭
搭积木是为了玩。	玩
看到豆花的时候会想要吃。	吃
运动是为了瘦。	瘦
累会导致不小心出车祸。	累
饱了就不想再吃了。	饱
渴会使人想买饮料。	渴
闲的时候会出去玩。	闲
灯会耗电。	灯
吵会导致听不见。	吵
叫会导致喉咙沙哑。	叫
叫会导致喉咙痛。	叫
冷的时候会围围巾。	冷
狗会对陌生人很凶。	狗
冷的时候会开暖炉。	冷
狗很忠心。	狗
臭会使人恶心。	臭
胖会导致人想减肥。	胖
饿了会想吃。	饿
饿了会想吃东西。	饿
饿了会想吃饭。	饿
冷的时候会想穿外套。	冷
人会发动战争。	人
人会玩手机。	人
饿了会找东西吃。	饿
冷的时候会拿暖暖包。	冷
臭会使人掩鼻。	臭
水是无色的。	水
狗是人类最好的朋友。	狗
水可以止渴。	水
狗会汪汪叫。	狗
累会令人没有精神。	累
水能清洗脏污。	水
火会烫伤人。	火
笑是因为看到有趣的事。	笑
线会缠绕成一团。	线
饿的时候肚子会叫。	饿
饿会导致胃痛。	饿
跑会脚酸。	跑
饿会导致血糖低。	饿
非法持枪会被查缉。	枪
坏人会被讨厌。	坏
水是透明的。	水
雨可能会造成水灾。	雨
闹钟会响。	响
鸟会飞。	飞
猪不用减肥。	猪
纸能用来书写。	纸
书能做的事情有帮助人了解历史。	书
纸能用来做成书本。	纸
开车能做的事情有兜风。	车
鱼会吃小虾米。	鱼
贼会吃牢饭。	贼
羊会咩咩叫。	羊
人能做的事情有念书写字。	人
手能做的事情有扇巴掌。	手
鱼能在水里生活。	鱼
书能做的事情有帮助人增长知识。	书
猫能做的事情有玩毛球。	猫
枪能做的事情有射击。	枪
狗能做的事情有当人类的好朋友。	狗
纸能用来折莲花。	纸
纸能用来折飞机。	纸
书能做的事情有帮助人提高分数。	书
书能做的事情有帮助人查阅新知。	书
牛能做的事情有犁田。	牛
药能止痛。	药
水能做的事情有冲马桶。	水
药能治病。	药
钱可以带来物质上的享受。	钱
钱可以用来环游世界。	钱
人会有苦恼。	人
树能让人乘凉。	树
酒可以让人喝醉。	酒
脚可以用来踢人。	脚
脚可以用来踹人。	脚
床可以用来躺着休息。	床
失败时会哭。	哭
忧郁时会哭。	哭
猫能做的事情有抓老鼠。	猫
狗能做的事情有汪汪叫。	狗
狗能做的事情有看家。	狗
子女会养老人。	养
醋是酸的。	酸
没钱是穷的。	穷
笔可以用来写字。	笔
猫会想要喵喵。	猫
笔可以用来画图。	笔
肚子饿会让你想要吃。	吃
北极会让你想到冷。	冷
南极会让你想到冷。	冷
吃汉堡会使你胖。	胖
宠物不见了会让你想要哭。	哭
宠物小鸡死掉会让你想要哭。	哭
撞到墙会让你想要哭。	哭
没吃午餐会让你感到饿。	饿
没吃宵夜会让你感到饿。	饿
没吃早餐会让你感到饿。	饿
没吃晚餐会让你感到饿。	饿
看感人的影片会让你想要哭。	哭
美食节目会让你感到饿。	饿
被冤枉的时候会让你想要哭。	哭
逛美食街会让你感到饿。	饿
追悼会让你想要哭。	哭
热了会脱衣服。	热
钱能让你买到很多东西。	钱
钱让你可以买东西。	钱
你想把钱存起来。	钱
水能维持生命。	水
笔能用来写字。	笔
钱可能会引来小偷。	钱
狗代表忠诚。	狗
药可以用来治病。	药
水可能用来浇花。	水
雨是甘霖。	雨
烟可能会引发肺癌。	烟
睡可能会引起落枕。	睡
花可能会引来蜜蜂。	花
花可能会引来蝴蝶。	花
不吃东西可能会让你饿。	饿
业余兼职可能会赚来钱。	钱
乐极可能会生悲。	悲
可乐会让你想要喝。	喝
吃太多可能会撑。	撑
吃鸡排可能会使人胖。	胖
看整夜的书会让你累。	累
喝很多水可能会想要尿。	尿
嘴角上扬代表笑。	笑
宅的意思是不出门。	宅
因为饿所以买宵夜。	饿
因为饿所以买菜做饭。	饿
因为饿所以买食物。	饿
因为饿所以买饭。	饿
口干舌燥是渴的表现。	渴
食物熟了可以吃。	熟
长得高有利于灌篮。	高
因为冷所以围着暖炉。	冷
宅的表现是待在家。	宅
因为有病所以在家休息。	病
小孩的天性是喜欢玩。	玩
巧克力的味道是甜的。	甜
因为饱所以打嗝。	饱
因为房间脏所以要打扫。	脏
因为累所以找按摩师按摩。	累
因为热所以拿扇子扇。	热
哭的时候会擦眼泪。	哭
壮的表现是有肌肉。	壮
因为冷所以要盖棉被。	冷
因为渴所以要喝水。	渴
因为脏所以要洗干净。	脏
灯的作用是照耀。	灯
因为渴所以烧开水喝。	渴
因为热所以吹电风扇。	热
因为胖所以想瘦身。	胖
渴的时候需要补充水分。	渴
因为有病所以要吃药。	病
因为有病所以要看医生。	病
因为对钱有贪念所以贪污。	钱
和熟的人相处比较轻松。	熟
一直吃的话会感觉饱。	饱
因为下雨所以地面很湿。	湿
不断地吃会感觉很饱。	饱
乌龟的速度很慢。	慢
因为事情一大堆所以感觉很烦。	烦
因为事情多所以感觉很烦。	烦
亲人去世的时候会哭。	哭
身上痒的时候会不自觉去抓。	抓
伤心难过的时候会哭。	哭
做家务让人感觉很累。	累
关灯之后会很黑。	黑
冬天的时候感觉很冷。	冷
因为冷气坏了所以感觉热。	热
化妆让人变得美。	美
因为吃了又吃所以感觉很饱。	饱
吃得少一般比较瘦。	瘦
夏天通常比较热。	热
因为有太多脂肪所以胖。	胖
囧是指在某种情况下很尴尬。	囧
幽默的人会让人想笑。	笑
因为很饿所以要吃东西。	吃
懒得出门是宅的表现。	宅
拉屎很臭。	臭
摔跤让人感觉痛。	痛
放屁很臭。	臭
因为晚饭吃太少所以饿。	饿
穷是指一个人没有钱。	穷
因为食物消化完了所以会感觉饿。	饿
被蚊子咬的地方很痒。	痒
山的形成可能因为地壳挤压。	山
大便很臭。	臭
大太阳会让人觉得热。	热
家教可以赚钱。	钱
快乐的时候你会想笑。	笑
怀孕的症状是想吐。	吐
悲痛的时候想哭。	哭
愉悦的时候会想笑。	笑
懂得理财可以赚到钱。	钱
成功的投资可以赚到钱。	钱
打哈欠代表你想睡。	睡
把猫卖掉可以获得钱。	钱
抠喉咙会让你想吐。	吐
抢劫是为了钱。	钱
抢银行是为了钱。	钱
提款是指取出钱。	钱
从车上摔下来让人感觉痛。	痛
晕机的时候想吐。	吐
晕船的时候想吐。	吐
晕车的时候吐。	吐
乌云的出现表示可能要下雨。	雨
有钱可以买东西。	买
没心跳表示一个人死了。	死
没收入会让人变穷。	穷
吃泡面会让你饱。	饱
淋雨会让人感觉很冷。	冷
熬夜太久让人很想睡。	睡
爬山可能让人感觉累。	累
电灯可以带来光。	光
电灯可以使环境变亮。	亮
疲倦会让你想睡。	睡
看悲剧的时候可能会哭。	哭
红包里一般有钱。	钱
继承遗产可以获得钱。	钱
缺东西的话会去买。	买
羽毛挠脚底会让你痒。	痒
股票涨可以赚到钱。	钱
被甩巴掌让你感觉痛。	痛
被蚊子叮的地方会痒。	痒
被蚊子咬的地方会痒。	痒
裤子穿反会让人感觉糗。	糗
过敏会让人感觉痒。	痒
运动过量可能让人感觉累。	累
镜子是用来照的。	照
难过的时候会想哭。	哭
饮料是用来喝的。	喝
高气温代表天气热。	热
吐可能代表吃到脏东西。	吐
吐可能代表吃坏东西。	吐
吐可能代表吃太多。	吐
笑可能代表喜悦。	笑
笑可能代表喜欢。	笑
吐可能代表喝醉酒。	吐
笑可能代表在玩乐。	笑
笑可能代表客套。	笑
笑可能代表尴尬。	笑
笑可能代表心情好。	笑
吐可能代表怀孕。	吐
笑可能代表愉快。	笑
哭可能代表感动。	哭
钱可能代表慾望。	钱
嗨可能代表打招唿。	嗨
笑可能代表掩饰。	笑
笑可能代表敷衍。	笑
哭可能代表无理取闹。	哭
打可能代表暴力。	打
叫可能代表有事情。	叫
笑可能代表有把握。	笑
痒可能代表有蚊子。	痒
花可能代表治丧。	花
笑可能代表满意。	笑
酒可能代表狂欢。	酒
痒可能代表要抓一下。	痒
钱可能代表财富。	钱
钱可能代表钞票。	钱
吐可能代表食物中毒。	吐
累的时候，你会不想动。	累
累的时候，你会不想思考。	累
饿的时候，你会买东西吃。	饿
饿的时候，你会买食物。	饿
累的时候，你会休息。	累
冷的时候，你会使用暖暖包。	冷
冷的时候，你会关窗户。	冷
饿的时候，你会去觅食。	饿
饿的时候，你会吃。	饿
饿的时候，你会吃大餐。	饿
饿的时候，你会吃水果。	饿
饿的时候，你会吃水饺。	饿
饿的时候，你会吃泡面。	饿
饿的时候，你会吃点心。	饿
饿的时候，你会吃锅贴。	饿
饿的时候，你会吃零食。	饿
饿的时候，你会吃面。	饿
饿的时候，你会吃面包。	饿
饿的时候，你会吃饼干。	饿
饿的时候，你会吃鸡排。	饿
饿的时候，你会吃麦当劳。	饿
热的时候，你会吹冷气。	热
热的时候，你会吹电风扇。	热
痛的时候，你会哭泣。	痛
冷的时候，你会喝热饮。	冷
笑的时候，你会嘴角上扬。	笑
冷的时候，你会多穿衣服。	冷
累的时候，你会小歇。	累
睡的时候，你会带眼罩。	睡
热的时候，你会开冷气。	热
冷的时候，你会开暖气。	冷
冷的时候，你会开暖炉。	冷
热的时候，你会开电扇。	热
冷的时候，你会开电暖器。	冷
累的时候，你会想休息。	累
饿的时候，你会想吃东西。	饿
饿的时候，你会想吃饭。	饿
热的时候，你会想吹冷气。	热
累的时候，你会想放假。	累
累的时候，你会想睡觉。	累
饿的时候，你会找东西吃。	饿
饿的时候，你会找水果吃。	饿
冷的时候，你会把窗户关起来。	冷
哭的时候，你会擦眼泪。	哭
累的时候，你会放松一下。	累
累的时候，你会泡澡。	累
哭的时候，你会流泪。	哭
哭的时候，你会流眼泪。	哭
哭的时候，你会流鼻涕。	哭
冷的时候，你会盖被子。	冷
累的时候，你会睡着。	累
睡的时候，你会磨牙。	睡
冷的时候，你会穿外套。	冷
冷的时候，你会穿衣服。	冷
冷的时候，你会穿起外套。	冷
饿的时候，你会肚子咕咕叫。	饿
热的时候，你会脱外套。	热
热的时候，你会脱衣服。	热
累的时候，你会补眠。	累
睡的时候，你会说梦话。	睡
累的时候，你会起来走走。	累
累的时候，你会趴下。	累
睡的时候，你会踢棉被。	睡
冷的时候，你会躲在被窝。	冷
哭的时候，你会躲起来。	哭
睡的时候，你会躺下来。	睡
累的时候，你会闭目养神。	累
下巴脱臼的时候，你会哭。	哭
下雪的时候的时候，你会冷。	冷
伤心的时候，你会哭。	哭
出事情的时候，你会哭。	哭
分手的时候，你会哭。	哭
发抖可能代表冷。	冷
受伤的时候，你会哭。	哭
受委屈的时候，你会哭。	哭
在分手之后，你会哭。	哭
在变身时，你会飞。	飞
在天国之门前，你会哭。	哭
在失恋时，你会哭。	哭
在学校，你会玩。	玩
在宠物离家出走，你会哭。	哭
在开心的时候，你会笑。	笑
在心情好时，你会笑。	笑
在忧郁时，你会哭。	哭
在放榜前，你会玩。	玩
在游乐场，你会玩。	玩
在生气的时候，你会哭。	哭
在看小丸子，你会笑。	笑
在结婚日，你会笑。	笑
在结婚纪念日，你会笑。	笑
在老虎面前，你会逃。	逃
在逃难的时候，你会哭。	哭
在酒池肉林，你会吃。	吃
在除夕，你会笑。	笑
在难过的时候，你会哭。	哭
在高兴时，你会笑。	笑
坠机的时候，你会死。	死
大可能代表重。	重
大地震的时候，你会跑。	跑
天气阴阴的可能代表凉。	凉
失望的时候，你会哭。	哭
头痛可能代表累。	累
头皮痒的时候，你会抓。	抓
孤独的时候，你会哭。	哭
开音乐的时候，你会听。	听
得到第一名可能代表强。	强
思念的时候，你会哭。	哭
恶心的时候，你会吐。	吐
想他的时候，你会笑。	笑
想喝水时可能代表渴。	渴
想喝汤可能代表渴。	渴
想喝饮料的时候，你会买。	买
想家的时候，你会哭。	哭
想念的时候，你会哭。	哭
感到孤单的时候，你会哭。	哭
慌张的时候，你会哭。	哭
打你的时候，你会哭。	哭
打小孩的时候，你会哭。	哭
打针的时候，你会痛。	痛
打雷的时候，你会怕。	怕
拍照的时候，你会笑。	笑
撞墙的时候，你会痛。	痛
晕倒可能代表累。	累
晕车的时候，你会吐。	吐
有人走了可能代表死。	死
有异味可能代表脏。	脏
有蜂窝的时候，你会跑。	跑
比大拇指可能代表赞。	赞
没钱可能代表穷。	穷
沮丧的时候，你会哭。	哭
流汗的时候，你会渴。	渴
海啸发生的时候，你会逃。	逃
满足的时候，你会笑。	笑
火山爆发的时候，你会跑。	跑
热身的时候，你会动。	动
照相的时候，你会笑。	笑
玩游戏的时候，你会笑。	笑
生日的时候，你会笑。	笑
电脑被偷的时候，你会哭。	哭
男生脱裤子可能代表热。	热
痛苦的时候，你会哭。	哭
看到邱毅假发的时候，你会笑。	笑
看康熙的时候，你会笑。	笑
看漫画的时候，你会笑。	笑
看笨版的时候，你会笑。	笑
穿很多衣服可能代表冷。	冷
穿风衣可能代表冷。	冷
红灯可能代表停。	停
考不好的时候，你会哭。	哭
考试不会写的时候，你会想。	想
聊天的时候，你会笑。	笑
肚子叫可能代表饿。	饿
肚子在叫可能代表饿。	饿
胖子可能代表肥。	肥
脱衣服的时候，你会冷。	冷
脱衣的时候，你会冷。	冷
脸红可能代表热。	热
荷包空空可能代表穷。	穷
落榜的时候，你会哭。	哭
蕃茄红了可能代表甜。	甜
虱子可能代表脏。	脏
被上司骂的时候，你会忍。	忍
被伯母骂的时候，你会哭。	哭
被抛弃的时候，你会哭。	哭
被揍的时候，你会痛。	痛
被狗追的时候，你会跑。	跑
被砍的时候，你会痛。	痛
被老师骂的时候，你会哭。	哭
被误会的时候，你会哭。	哭
被踢到膝盖的时候，你会痛。	痛
被追杀的时候，你会跑。	跑
赌输的时候，你会囧。	囧
走路的时候，你会累。	累
赶报告的时候，你会累。	累
身体不适的时候，你会累。	累
还没到期限的时候，你会拖。	拖
迷路的时候，你会哭。	哭
逃跑的时候，你会喘。	喘
逛joke板的时候，你会笑。	笑
遇到色狼的时候，你会逃。	逃
钱包不见可能代表衰。	衰
钱包空了可能代表穷。	穷
水在井里。	水
枪在军火库里。	枪
义在利益外。	义
床在卧室里。	床
云在对流层下。	云
钱在帐户里。	钱
花在情人手里。	花
钱在收银机里。	钱
草在水族箱里。	草
鱼在水族缸里。	鱼
鱼在水池里。	鱼
鱼在水缸里。	鱼
水在池子里。	水
鱼在河水里。	鱼
水在浴缸里。	水
花在温室里。	花
鱼在湖泊里。	鱼
鱼在溪流里。	鱼
鱼在溪里。	鱼
铅在笔心里。	铅
尺在笔袋里。	尺
蛆在粪坑里。	蛆
钱在红包里。	钱
心在胸腔里。	心
水在脸盆里。	水
牙在舌头外。	牙
水在茶壶里。	水
钱在荷包里。	钱
脚在裤子下。	脚
钱在金库里。	钱
钱在银行里里。	钱
火在锅子下。	火
水在鱼缸里。	水
家有一宝。	家
家有一老。	家
人有三急。	人
人有亲戚。	人
水有冰点。	水
人有勇气。	人
书有原文。	书
家有喜事。	家
家有四千金。	家
人有头脑。	人
家有姐姐。	家
家有客厅。	家
书有封面。	书
人有工作能力。	人
家有幸福的味道。	家
人有思考能力。	人
家有恶妻。	家
家有恶犬。	家
人有情感。	人
人有情绪。	人
人有感情。	人
人有慾望。	人
心有房室瓣。	心
家有房间。	家
人有手脚。	人
书有故事。	书
车有方向盘。	车
人有智商。	人
人有智慧。	人
信有格式。	信
狗有灵敏的嗅觉。	狗
家有父母。	家
家有爸妈。	家
家有爸爸。	家
家有狗狗。	家
家有电视。	家
书有知识。	书
饭有碳水化合物。	饭
人有良心。	人
人有良知。	人
家有贤妻。	家
家有贱狗。	家
人有道德观念。	人
家有难唸的经。	家
书有页码。	书
上班有钱。	钱
下课后在家里。	家
临检的警察在车外。	车
主人在楼下。	楼
主人在家里。	家
乌云在窗外。	窗
乌龟有壳。	壳
乘凉的人在树下。	树
乡民在城外。	城
书本中有字。	字
书本里有字。	字
云吞面有汤。	汤
交通银行有钱。	钱
亲情在家里。	家
亲爱的阿嬷在家里。	家
人面狮身像在国外。	国
企业总部在海外。	海
休闲娱乐在户外。	户
传统早餐有粥。	粥
你可以在家找到书桌。	家
你可以在家找到卫生纸。	家
你可以在家找到妈妈。	家
你可以在家找到床铺。	家
你可以在家找到快乐。	家
你可以在家找到桌子。	家
你可以在家找到椅子。	家
你可以在家找到浴室。	家
你可以在家找到温暖。	家
你可以在家找到温馨。	家
你可以在家找到烤箱。	家
你可以在家找到球拍。	家
你可以在家找到电灯。	家
你可以在家找到电脑。	家
你可以在家找到蟑螂。	家
你可以在家找到钥匙。	家
你可以在家找到食物。	家
你可以在家找到餐桌。	家
你可以在中央银行找到钱。	钱
你可以在书中找到字。	字
你可以在体育器材室找到球。	球
你可以在体育场找到球。	球
你可以在体育用品店找到球。	球
你可以在体育馆找到球。	球
你可以在冷冻库找到冰。	冰
你可以在冷泉找到水。	水
你可以在列表机找到纸。	纸
你可以在加油站找到车。	车
你可以在北海岸找到鱼。	鱼
你可以在台湾菸酒找到烟。	烟
你可以在土里找到泥。	泥
你可以在地中海找到船。	船
你可以在大江找到鱼。	鱼
你可以在大甲溪找到水。	水
你可以在央行找到钱。	钱
你可以在富士山找到雪。	雪
你可以在尼加拉瓜瀑布找到水。	水
你可以在建筑工地找到泥。	泥
你可以在很多地方找到书。	书
你可以在收银台找到钱。	钱
你可以在文化馆找到书。	书
你可以在杉林溪森林游乐区找到水。	水
你可以在水族箱找到鱼。	鱼
你可以在汇丰找到钱。	钱
你可以在池塘里找到鱼。	鱼
你可以在池糖里找到水。	水
你可以在海湾找到鱼。	鱼
你可以在渔港找到鱼。	鱼
你可以在港区找到船。	船
你可以在澡堂找到水。	水
你可以在生机饮食找到菜。	菜
你可以在皇家俱乐部找到人。	人
你可以在皇家找到王。	王
你可以在皮包里找到钱。	钱
你可以在皮夹找到钱。	钱
你可以在系办找到人。	人
你可以在红包里找到钱。	钱
你可以在绿洲找到水。	水
你可以在网球场找到人。	人
你可以在美术馆找到画。	画
你可以在翡翠湾找到海。	海
你可以在联谊会找到人。	人
你可以在花旗台湾银行找到钱。	钱
你可以在花莲县文化局找到人。	人
你可以在花莲吉安乡找到人。	人
你可以在藏经阁找到书。	书
你可以在补习班找到人。	人
你可以在观光区找到人。	人
你可以在赌场找到人。	人
你可以在超商找到水。	水
你可以在越南找到人。	人
你可以在身体里找到胃。	胃
你可以在车站找到人。	人
你可以在运动商店找到球。	球
你可以在运动用品店找到球。	球
你可以在野生乐园找到狼。	狼
你可以在金石堂找到书。	书
你可以在金钱豹找到酒。	酒
你可以在阿尔卑斯山找到雪。	雪
你可以在阿里山乡找到人。	人
你可以在雪霸国家公园管理处找到人。	人
你可以在顶好超商找到盐。	盐
你可以在飞机窗外找到云。	云
你可以在餐桌上找到碗。	碗
你可以在香江找到鱼。	鱼
你可以在马来西亚找到人。	人
你可以在高铁站找到人。	人
你可以在高雄市政府找到人。	人
你可以在高雄应用科技找到人。	人
你可以在高雄旗津找到船。	船
你可以在魔兽世界找到人。	人
停车场在楼下。	楼
先人埋在地下。	地
公寓有床。	床
兵营有枪。	枪
内容在书里。	书
冰层有水。	水
出入门在楼下。	楼
匈奴在塞外。	塞
化石在地下。	地
化粪池有屎。	屎
华侨在海外。	海
台风天有雨。	雨
听歌有趣。	趣
回忆在心里。	心
土拨鼠在地里。	地
地瓜在土里。	土
夏天有蝉。	蝉
外星人在天外。	天
大肠在胃下。	胃
太空在天外。	天
头皮在脑外。	脑
姜饼屋有糖。	糖
子弹在枪里。	枪
学问在书里。	书
宁胡阙式在塞外。	塞
富商有钱。	钱
寝室有床。	床
小山坡在郊外。	郊
小河在桥下。	桥
小王子在书里。	书
尸体埋在土里。	土
屁股有肉。	肉
岩层在地下。	地
希望在心里。	心
干净空气在郊外。	郊
底盘在车下。	车
忘记的功课在家里。	家
恨你在心里。	心
情感在心里。	心
感动在心里。	心
我家汽车停在楼下。	楼
我的爱在心里。	心
打棒球在户外。	户
挫冰在碗里。	碗
捷运站在地下。	地
插座有电。	电
操场上有草。	草
明妃在塞外。	塞
星星在云里。	云
暗恋在心里。	心
暗爽在心里。	心
月亮在云里。	云
朋友在心里。	心
木炭在火里。	火
杨过在书里。	书
桂圆蛋糕有糖。	糖
梅花鹿在野外。	野
梦想在心里。	心
森林在户外。	户
正义在心里。	心
水母有毒。	毒
汽水有糖。	糖
河谷在山下。	山
泳池有水。	水
海上有船。	船
海带在水下。	水
海绵宝宝在水里。	水
海葵在水里。	水
游泳池里有水。	水
滑鼠在手下。	手
滑鼠垫在手下。	手
漫画有趣。	趣
火龙果有籽。	籽
爱你在心里。	心
爱你有情。	情
牙齿在嘴里。	嘴
犯人有罪。	罪
狐臭在腋下。	腋
玉门关在城外。	城
王昭君在塞外。	塞
王永庆有钱。	钱
珍珠奶茶有糖。	糖
瓦斯炉有火。	火
生气在心里。	心
电视在屋里。	屋
番薯长在地下。	地
皮卡丘有电。	电
睿靓家有床。	床
秀姑峦溪有水。	水
种子在地下。	地
种子在土里。	土
秘密在心里。	心
章鱼在水里。	水
答案在书里。	书
箱子有锁。	锁
纤维素在草里。	草
美景在窗外。	窗
美术馆里有画。	画
老板在店里。	店
老板娘在店里。	店
老板有钱。	钱
舌头在嘴里。	嘴
艺术馆有画。	画
花圃在楼下。	楼
花生在地下。	地
草原在郊外。	郊
草皮在户外。	户
萝卜在土里。	土
落叶在树下。	树
蜈蚣在土里。	土
被判罪的人在牢里。	牢
西瓜在土里。	土
西瓜有子。	子
警察有枪。	枪
警局有枪。	枪
诊所有药。	药
豆花在碗里。	碗
足球场上有草。	草
车子停在门外。	门
轮子在车下。	车
轮胎在车下。	车
郭台铭有钱。	钱
金鱼在水里。	水
钥匙孔在门外。	门
长笛有洞。	洞
门牌在墙外。	墙
阳台在室外。	室
阴暗角落有尘。	尘
院子有草。	草
难过在心里。	心
雨刷在车外。	车
食物在胃里。	胃
饮料有糖。	糖
香肠在碗里。	碗
马克杯里有水。	水
马桶有洞。	洞
马铃薯在地下。	地
鱼掉在网外。	网
鲨鱼在水里。	水
鸡腿在碗里。	碗
鸡蛋在碗里。	碗
麦片在碗里。	碗
黑影在窗外。	窗
鼹鼠在地里。	地
B咖主持人想要红。	红
狗喜欢乱咬东西。	狗
猪喜欢吃。	猪
鸟喜欢吃小虫。	鸟
猫喜欢吃老鼠。	猫
牛喜欢吃草。	牛
鸟喜欢吃虫。	鸟
鱼喜欢吃饵料。	鱼
狗喜欢吐舌头。	狗
鸟喜欢吱吱叫。	鸟
狗喜欢咬骨头。	狗
鸡喜欢啄小虫。	鸡
鱼喜欢在水里。	鱼
鱼喜欢在水里游。	鱼
猫喜欢夜行。	猫
猫喜欢抓主人。	猫
猫喜欢抓鱼。	猫
狗喜欢接飞盘。	狗
狗喜欢摇尾巴。	狗
鸡喜欢斗蜈蚣。	鸡
猫喜欢毛球。	猫
猫喜欢毛线。	猫
狗喜欢汪汪叫。	狗
鱼喜欢游来游去。	鱼
猫喜欢爬树。	猫
蛇喜欢爬行。	蛇
猫喜欢爬高。	猫
猫喜欢玩会动的东西。	猫
猫喜欢玩毛球。	猫
猫喜欢玩毛线。	猫
狗喜欢看家。	狗
鸟喜欢站树上。	鸟
猫喜欢舔毛。	猫
狗喜欢跟着主人。	狗
猫喜欢追老鼠。	猫
狗喜欢骨头。	狗
鱼惧怕没水。	鱼
羊惧怕没草吃。	羊
狗惧怕被遗弃。	狗
贼惧怕警察。	贼
虫惧怕鸡。	虫
虫惧怕麻雀。	虫
猫想要吃小鱼干。	猫
猫想要玩毛毛球。	猫
鱼痛恨渔夫。	鱼
鱼痛恨钓钩。	鱼
上班族想要钱。	钱
乐观的人喜欢笑。	笑
人都想要钱。	钱
仓鼠惧怕猫。	猫
伤心想要哭。	哭
伤心时想要哭。	哭
受伤想要哭。	哭
大老鼠惧怕猫。	猫
天竺鼠惧怕猫。	猫
失恋的时候想要哭。	哭
失意的时候想要哭。	哭
孤儿想要家。	家
小白鼠惧怕猫。	猫
小红帽惧怕狼。	狼
很感动时想要哭。	哭
快迟到了就会想要跑。	跑
怕鬼的人惧怕黑。	黑
悲伤想要哭。	哭
悲伤时想要哭。	哭
想变富有所以想要钱。	钱
新袜子惧怕脏。	脏
旱鸭子惧怕水。	水
杰利鼠惧怕猫。	猫
杰力鼠惧怕猫。	猫
森林惧怕火。	火
欠卡债的人想要钱。	钱
母亲过世时想要哭。	哭
水老鼠惧怕猫。	猫
没有人不喜欢钱。	钱
火焰惧怕水。	水
猪八戒喜欢吃。	吃
球迷想要赢。	赢
瓦斯行惧怕火。	火
生意人想要钱。	钱
田鼠惧怕猫。	猫
电器用品惧怕水。	水
疼痛想要哭。	哭
素食者痛恨肉。	肉
蛇在冬天喜欢睡。	睡
蝴蝶喜欢花。	花
被搔痒想要笑。	笑
贫穷的人想要钱。	钱
难过想要哭。	哭
难过时想要哭。	哭
鼹鼠惧怕蛇。	蛇
98无铅汽油的原料是碳。	碳
布可以拿来做成T恤。	布
水可以拿来做成冰块。	水
纸可以拿来做成卡片。	纸
米可以拿来做成年糕。	米
布可以拿来做成床单。	布
书可以用再生纸制成。	书
书可以用印刷机制成。	书
钱可以用印钞机制成。	钱
书可以用回收纸制成。	书
书可以用很多纸制成。	书
路可以用柏油制成。	路
水可以用氢与氧制成。	水
水可以用氢气与氧气制成。	水
水可以用氢气跟氧气制成。	水
水可以用氢跟氧制成。	水
伞可以用油纸制成。	伞
糖可以用甜菜制成。	糖
酒可以用白葡萄制成。	酒
书可以用竹简制成。	书
酒可以用葡萄制成。	酒
布可以用麻制成。	布
水由H和O组成。	水
书由很多张纸组成。	书
水由氢和氧组成。	水
水由氢氧组成。	水
酒的原料是乙醇。	酒
茶的原料是叶子。	茶
茶的原料是叶片。	茶
面的原料是小麦。	面
纸的原料是木浆。	纸
茶的原料是树叶。	茶
路的原料是沥青。	路
面的原料是麦子。	面
不锈钢可以用铁制成。	铁
书卷可以用纸制成。	纸
公益彩券的原料是纸。	纸
刨冰可以用水制成。	水
千元大钞可以用纸制成。	纸
半年报的原料是纸。	纸
名片可以用纸制成。	纸
地图可以用纸制成。	纸
大海由水组成。	水
字典可以用纸制成。	纸
小河由水组成。	水
披风的原料是布。	布
文章由字组成。	字
新台币的原料是纸。	纸
月历可以用纸制成。	纸
木片可以用树制成。	树
杂志可以用纸制成。	纸
杯垫可以用布制成。	布
桌巾可以用布制成。	布
椅套可以用布制成。	布
氧气可以用水制成。	水
河流由水组成。	水
海报的原料是纸。	纸
消费券可以用纸制成。	纸
火腿由肉组成。	肉
灯笼可以用纸制成。	纸
热水瓶可以用钢制成。	钢
玻璃可以用硅制成。	硅
盒子可以用纸制成。	纸
礼盒的原料是纸。	纸
窗帘可以用布制成。	布
箱子可以用纸制成。	纸
粽子的原料是米。	米
统一发票可以用纸制成。	纸
钞票可以用纸制成。	纸
钢弹可以用铁制成。	铁
钢筋可以用铁制成。	铁
钱包可以用皮制成。	皮
铅球可以用铁制成。	铁
锁匙可以用铁制成。	铁
门帘可以用布制成。	布
门把可以用铁制成。	铁
面粉可以拿来做成派。	派
睡是为了补充元气。	睡
饿的时候会想要买东西吃。	饿
饿的时候会想要买便当。	饿
饿的时候会想要买宵夜。	饿
渴的时候会想要买水。	渴
饿的时候会想要买食物。	饿
饿的时候会想要买饭。	饿
渴的时候会想要买饮料。	渴
累的时候会想要倒头大睡。	累
渴的时候会想要倒水喝。	渴
饿的时候会想要出去吃饭。	饿
哭的时候会想要别人来安慰。	哭
冷的时候会想要取暖。	冷
饿的时候会想要叫外卖。	饿
饿的时候会想要叫外送。	饿
饿的时候会想要吃便当。	饿
饿的时候会想要吃到饱。	饿
饿的时候会想要吃包子。	饿
饿的时候会想要吃大餐。	饿
饿的时候会想要吃拉面。	饿
饿的时候会想要吃水饺。	饿
饿的时候会想要吃汉堡。	饿
饿的时候会想要吃泡面。	饿
饿的时候会想要吃炒饭。	饿
饿的时候会想要吃炸鸡。	饿
饿的时候会想要吃牛排。	饿
饿的时候会想要吃牛肉面。	饿
饿的时候会想要吃米粉。	饿
饿的时候会想要吃美食。	饿
饿的时候会想要吃面。	饿
饿的时候会想要吃面包。	饿
饿的时候会想要吃饼干。	饿
饿的时候会想要吃鸡排。	饿
饿的时候会想要吃麦当劳。	饿
热的时候会想要吹电风扇。	热
累的时候会想要眯一下。	累
热的时候会想要喝冰水。	热
热的时候会想要喝冷饮。	热
冷的时候会想要喝热水。	冷
冷的时候会想要喝热汤。	冷
冷的时候会想要喝热茶。	冷
冷的时候会想要围围巾。	冷
累的时候会想要坐下。	累
累的时候会想要坐下来。	累
累的时候会想要坐着。	累
饿的时候会想要填饱肚子。	饿
忙的时候会想要多一点时间。	忙
饿的时候会想要大吃一顿。	饿
累的时候会想要大睡一番。	累
困的时候会想要好好休息。	困
困的时候会想要好好睡觉。	困
哭的时候会想要安慰。	哭
累的时候会想要小憩。	累
累的时候会想要小憩片刻。	累
热的时候会想要开冷气。	热
冷的时候会想要开暖气。	冷
热的时候会想要开电扇。	热
热的时候会想要开电风扇。	热
热的时候会想要待在冷气房。	热
累的时候会想要待在家。	累
哭的时候会想要得到安慰。	哭
饿的时候会想要找东西吃。	饿
哭的时候会想要找人安慰。	哭
饿的时候会想要找食物。	饿
饿的时候会想要找餐厅。	饿
烦的时候会想要抱怨。	烦
累的时候会想要按摩。	累
烦的时候会想要散心。	烦
哭的时候会想要有人安慰。	哭
累的时候会想要歇一会儿。	累
饿的时候会想要泡泡面。	饿
饿的时候会想要泡面。	饿
脏的时候会想要洗干净。	脏
饿的时候会想要煮东西。	饿
饿的时候会想要煮泡面。	饿
饿的时候会想要煮面。	饿
冷的时候会想要用暖暖包。	冷
饿的时候会想要看有没有吃的。	饿
困的时候会想要睡一下。	困
渴的时候会想要补充水分。	渴
哭的时候会想要被安慰。	哭
饿的时候会想要觅食。	饿
累的时候会想要趴下休息。	累
困的时候会想要趴下去睡。	困
累的时候会想要趴着。	累
累的时候会想要躺下。	累
累的时候会想要躺下来休息。	累
累的时候会想要躺着。	累
饿的时候会想要进食。	饿
不开心的时候会想要哭。	哭
不快乐的时候会想要哭。	哭
不高兴的时候会想要哭。	哭
买便当是为了吃。	吃
你会累因为你一直没休息。	累
你会饿因为你上一餐没吃。	饿
你会热因为你不开冷气。	热
你会哭因为你亲人过世。	哭
你会哭因为你伤心难过。	哭
你会累因为你刚上完班。	累
你会累因为你刚下班。	累
你会哭因为你刚失恋。	哭
你会哭因为你受委屈。	哭
你会哭因为你哀伤。	哭
你会哭因为你哀痛。	哭
你会饿因为你太久没吃。	饿
你会渴因为你太久没喝水。	渴
你会哭因为你太伤心。	哭
你会哭因为你委屈。	哭
你会饿因为你很久没吃。	饿
你会饿因为你很久没吃东西。	饿
你会哭因为你很伤心。	哭
你会哭因为你很难过。	哭
你会笑因为你很高兴。	笑
你会哭因为你心痛。	哭
你会哭因为你感到难过。	哭
你会累因为你熬夜念书。	累
你会累因为你熬夜通宵。	累
你会笑因为你看喜剧片。	笑
你会哭因为你看悲剧电影。	哭
你会累因为你睡眠不足。	累
你会热因为你穿太多。	热
你会热因为你穿太多了。	热
你会热因为你穿太多衣服。	热
你会冷因为你穿太少。	冷
你会冷因为你穿太少衣服。	冷
你会哭因为你被抛弃。	哭
你会笑因为你被搔痒。	笑
你会笑因为你被搔痒了。	笑
你会哭因为你被欺负。	哭
你会哭因为你觉得受伤。	哭
你会笑因为你觉得好玩。	笑
你会哭因为你觉得委屈。	哭
你会累因为你过度操劳。	累
你会累因为你连上八堂课。	累
你会累因为你通宵。	累
你会哭因为你遗憾。	哭
你会哭因为你钱被偷了。	哭
你会饿因为你闻到食物的味。	饿
你会死因为你阳寿已尽。	死
你会哭因为你难受。	哭
你会喝因为你非常渴。	喝
你会哭因为你非常难过。	哭
你会笑因为你顺心。	笑
你会吐因为你饮酒过量。	吐
你会痛因为你骨折。	痛
你会买吃的因为你饿。	饿
你会吃冰因为你热。	热
你会吃咖哩因为你饿。	饿
你会吃宵夜因为你饿。	饿
你会吃点心因为你饿。	饿
你会吃蛋挞因为你饿。	饿
你会吹电扇因为你热。	热
你会哭泣因为你痛。	痛
你会大叫因为你痛。	痛
你会奔跑因为你急。	急
你会想吃因为你饿。	饿
你会想要吃东西因为你饿。	饿
你会打滚因为你痛。	痛
你会流口水因为你饿。	饿
你会煮饭因为你饿。	饿
你会睡着因为你累。	累
你会穿外套因为你冷。	冷
你会脱衣服因为你热。	热
做错事的时候会想要哭。	哭
做面包的时候会想要吃。	吃
养电子鸡是为了玩。	玩
冲刺是为了赢。	赢
分手的时候会想要哭。	哭
勒索的时候会想要钱。	钱
受伤的时候会想要哭。	哭
吃太多的时候会想要吐。	吐
吃太撑的时候会想要吐。	吐
吃安眠药的时候会想要睡。	睡
吃屎的时候会想要吐。	吐
吵架的时候会想要哭。	哭
喝醉的时候会想要吐。	吐
嘴馋的时候会想要吃。	吃
失火的时候会想要逃。	逃
头晕的时候会想要吐。	吐
学得开心的时候会想要笑。	笑
宠物太容易饿的时候会想要吃。	吃
工作的时候会想要钱。	钱
当你想要钱的时候你可能会买刮刮乐。	钱
当你想要买的时候你可能会付钱。	买
当你想要钱的时候你可能会借贷。	钱
当你想要哭的时候你可能会关门。	哭
当你想要哭的时候你可能会到厕所里。	哭
当你想要钱的时候你可能会努力加班。	钱
当你想要钱的时候你可能会努力去赚。	钱
当你想要钱的时候你可能会努力打工。	钱
当你想要哭的时候你可能会努力调适心情。	哭
当你想要钱的时候你可能会募款。	钱
当你想要笑的时候你可能会去joke板。	笑
当你想要钱的时候你可能会去上班赚。	钱
当你想要钱的时候你可能会去兼差。	钱
当你想要钱的时候你可能会去兼职。	钱
当你想要吐的时候你可能会去厕所。	吐
当你想要玩的时候你可能会去夜唱。	玩
当你想要钱的时候你可能会去工地赚。	钱
当你想要玩的时候你可能会去海边。	玩
当你想要玩的时候你可能会去游乐园。	玩
当你想要逛的时候你可能会去走走。	逛
当你想要笑的时候你可能会嘴角上扬。	笑
当你想要钱的时候你可能会寻找工作。	钱
当你想要钱的时候你可能会开店。	钱
当你想要哭的时候你可能会很伤心。	哭
当你想要钱的时候你可能会很努力赚。	钱
当你想要哭的时候你可能会很悲伤。	哭
当你想要哭的时候你可能会很难过。	哭
当你想要哭的时候你可能会心情低落。	哭
当你想要哭的时候你可能会忍住眼泪。	哭
当你想要哭的时候你可能会忍耐。	哭
当你想要钱的时候你可能会想到爸妈。	钱
当你想要喝的时候你可能会打开可口可乐。	喝
当你想要玩的时候你可能会打电动。	玩
当你想要钱的时候你可能会打电话给妈妈。	钱
当你想要哭的时候你可能会打电话给老公。	哭
当你想要哭的时候你可能会找个肩膀。	哭
当你想要吐的时候你可能会找厕所。	吐
当你想要哭的时候你可能会找地方静一静。	哭
当你想要玩的时候你可能会把作业写完。	玩
当你想要玩的时候你可能会把家事做完。	玩
当你想要钱的时候你可能会抢邮局。	钱
当你想要红的时候你可能会报名星光大道。	红
当你想要哭的时候你可能会抱人。	哭
当你想要钱的时候你可能会拉赞助。	钱
当你想要飞的时候你可能会拍动翅膀。	飞
当你想要哭的时候你可能会拿卫生纸。	哭
当你想要吐的时候你可能会拿塑胶袋。	吐
当你想要钱的时候你可能会拿奖学金。	钱
当你想要哭的时候你可能会拿手帕。	哭
当你想要钱的时候你可能会提款。	钱
当你想要钱的时候你可能会教家教。	钱
当你想要哭的时候你可能会有人陪。	哭
当你想要钱的时候你可能会用功唸书。	钱
当你想要笑的时候你可能会看喜剧。	笑
当你想要笑的时候你可能会看四格漫画。	笑
当你想要逛的时候你可能会看天气。	逛
当你想要笑的时候你可能会看康熙来了。	笑
当你想要笑的时候你可能会看漫画。	笑
当你想要笑的时候你可能会看笨版。	笑
当你想要玩的时候你可能会约朋友。	玩
当你想要钱的时候你可能会经营生意。	钱
当你想要飞的时候你可能会装翅膀。	飞
当你想要死的时候你可能会豁出去了。	死
当你想要逛的时候你可能会走出房间。	逛
当你想要逛的时候你可能会走出门。	逛
当你想要逛的时候你可能会走动。	逛
当你想要吐的时候你可能会跑厕所。	吐
当你想要哭的时候你可能会跑走。	哭
当你想要钱的时候你可能会跟妈妈要。	钱
当你想要钱的时候你可能会跟爸妈要。	钱
当你想要钱的时候你可能会跟爸妈说。	钱
当你想要钱的时候你可能会跟爸爸要。	钱
当你想要钱的时候你可能会跟老板支薪。	钱
当你想要钱的时候你可能会跟老爸要。	钱
当你想要哭的时候你可能会躲在棉被。	哭
当你想要哭的时候你可能会躲棉被里。	哭
当你想要哭的时候你可能会躲起来。	哭
当你想要哭的时候你可能会躲进厕所。	哭
当你想要钱的时候你可能会邮局领。	钱
当你想要哭的时候你可能会靠在别人怀里。	哭
当你想要哭的时候你可能会鼻子红。	哭
当你想要吃大汉堡的时候你可能会买。	买
当你想要吃面的时候你可能会买。	买
当你想要开电脑的时候你可能会玩。	玩
当你想要打电脑的时候你可能会玩。	玩
当你想要放弃的时候你可能会哭。	哭
当你想要碗盘的时候你可能会买。	买
当你想要跳舞的时候你可能会笑。	笑
当你想要追公车的时候你可能会跑。	跑
很困的时候会想要睡。	睡
很快乐的时候会想要笑。	笑
心碎的时候会想要哭。	哭
忧郁的时候会想要哭。	哭
怀孕的时候会想要吐。	吐
恋爱的时候会想要笑。	笑
想不开的时候会想要哭。	哭
想妳的时候的时候会想要哭。	哭
想家的时候会想要哭。	哭
想念的时候会想要哭。	哭
想睡的时候会想要床。	床
想要有钱应该要一技之长。	钱
想要有钱应该要上班。	钱
想要有名应该要上电视。	名
想要有钱应该要上进。	钱
想要有钱应该要上进心。	钱
想要有钱应该要下对方针。	钱
想要有钱应该要下注。	钱
想要有钱应该要下海。	钱
想要有钱应该要不乱买东西啊。	钱
想要有钱应该要不乱挥霍。	钱
想要有钱应该要不乱花。	钱
想要有钱应该要不停的赚。	钱
想要有钱应该要不偷懒。	钱
想要有钱应该要不怕苦。	钱
想要有钱应该要不浪费。	钱
想要有钱应该要不要乱买。	钱
想要有钱应该要不要随便乱花。	钱
想要有钱应该要不轻言放弃。	钱
想要有钱应该要不追求名牌。	钱
想要有钱应该要专心工作。	钱
想要有钱应该要中乐透。	钱
想要有钱应该要中头奖。	钱
想要有钱应该要中奖。	钱
想要有钱应该要乖乖上班。	钱
想要有钱应该要乖乖唸书。	钱
想要有钱应该要乞讨。	钱
想要有钱应该要买乐透碰运气。	钱
想要有钱应该要买低卖高。	钱
想要有钱应该要买基金。	钱
想要有钱应该要买大乐透。	钱
想要有钱应该要买威利彩。	钱
想要有钱应该要买威力彩。	钱
想要有钱应该要买彩券。	钱
想要有钱应该要买楼收租。	钱
想要有钱应该要买股票。	钱
想要有钱应该要争取工资加薪。	钱
想要有钱应该要从商。	钱
想要有钱应该要付出代价去赚。	钱
想要有钱应该要付出努力。	钱
想要有钱应该要付出劳力。	钱
想要有钱应该要会投资。	钱
想要有钱应该要会理财。	钱
想要有钱应该要伸手向父母拿。	钱
想要有钱应该要作好投资。	钱
想要有钱应该要作投资。	钱
想要有钱应该要作生意。	钱
想要有钱应该要做大老板。	钱
想要有钱应该要做好理财。	钱
想要有钱应该要做工作。	钱
想要有钱应该要做生意。	钱
想要有钱应该要做苦力。	钱
想要有钱应该要健康。	钱
想要有钱应该要偷拐抢骗。	钱
想要有钱应该要偷机。	钱
想要有钱应该要充实自己。	钱
想要有钱应该要先找到工作。	钱
想要有饭应该要先洗米。	饭
想要有钱应该要典当。	钱
想要有钱应该要兼家教。	钱
想要有钱应该要兼差。	钱
想要有钱应该要兼职。	钱
想要有钱应该要内线交易。	钱
想要有钱应该要减少负债。	钱
想要有钱应该要出劳力。	钱
想要有钱应该要出卖劳力。	钱
想要有钱应该要创业。	钱
想要有名应该要制造新闻。	名
想要有钱应该要刻苦耐劳。	钱
想要有钱应该要加油。	钱
想要有钱应该要加班。	钱
想要有钱应该要动头脑。	钱
想要有钱应该要动脑。	钱
想要有钱应该要动脑筋。	钱
想要有钱应该要动脑袋瓜儿。	钱
想要有钱应该要努力上班。	钱
想要有钱应该要努力上进。	钱
想要有钱应该要努力不懈。	钱
想要有钱应该要努力争取机会。	钱
想要有钱应该要努力以赴。	钱
想要有钱应该要努力向上。	钱
想要有钱应该要努力向学。	钱
想要有钱应该要努力唸书。	钱
想要有钱应该要努力学习。	钱
想要有钱应该要努力念书。	钱
想要有钱应该要努力打拼。	钱
想要有钱应该要努力找工作。	钱
想要有钱应该要努力投资。	钱
想要有钱应该要努力点。	钱
想要有钱应该要努力用功。	钱
想要有钱应该要努力读书。	钱
想要有钱应该要努力赚。	钱
想要有钱应该要勤劳。	钱
想要有钱应该要勤奋。	钱
想要有钱应该要勤奋工作。	钱
想要有钱应该要卖东西。	钱
想要有钱应该要卖春。	钱
想要有钱应该要卖身。	钱
想要有钱应该要卖陶瓷娃娃。	钱
想要有钱应该要印钞票。	钱
想要有钱应该要去上班。	钱
想要有钱应该要去工作。	钱
想要有钱应该要去当明星。	钱
想要有钱应该要去当舖。	钱
想要有钱应该要去打工。	钱
想要有钱应该要去投资。	钱
想要有钱应该要去抢。	钱
想要有钱应该要去赌博。	钱
想要有钱应该要去赚。	钱
想要有钱应该要发愤。	钱
想要有钱应该要发文。	钱
想要有钱应该要发财。	钱
想要有钱应该要变勤劳。	钱
想要有钱应该要吃苦。	钱
想要有钱应该要向上。	钱
想要有钱应该要向人乞讨。	钱
想要有钱应该要向成功人学习。	钱
想要有钱应该要唸书。	钱
想要有钱应该要善于投资。	钱
想要有钱应该要善于理财。	钱
想要有钱应该要培养专长。	钱
想要有钱应该要培养工作实力。	钱
想要有钱应该要增加实力。	钱
想要有钱应该要多买乐透。	钱
想要有钱应该要多充实自己。	钱
想要有钱应该要多兼差。	钱
想要有钱应该要多写文章。	钱
想要有钱应该要多唸书。	钱
想要有钱应该要多投资。	钱
想要有钱应该要多看书。	钱
想要有钱应该要多读书。	钱
想要有钱应该要多读书多赚。	钱
想要有钱应该要奋发。	钱
想要有钱应该要奋发向上。	钱
想要有钱应该要好好储蓄。	钱
想要有钱应该要好好唸书。	钱
想要有钱应该要好好念书。	钱
想要有钱应该要好好打拼。	钱
想要有钱应该要好好读书。	钱
想要有钱应该要好的投资。	钱
想要有钱应该要妥善投资。	钱
想要有钱应该要妥善理财。	钱
想要有钱应该要嫁入豪门。	钱
想要有钱应该要存款。	钱
想要有钱应该要存起来。	钱
想要有钱应该要存银行。	钱
想要有钱应该要学一技之长。	钱
想要有钱应该要学习。	钱
想要有钱应该要学习专长。	钱
想要有钱应该要学习投资理财。	钱
想要有钱应该要学习理财。	钱
想要有钱应该要学习理财规划。	钱
想要有钱应该要学会投资。	钱
想要有钱应该要学理财。	钱
想要有鸡应该要孵蛋。	鸡
想要有钱应该要定存。	钱
想要有钱应该要定期储蓄。	钱
想要有钱应该要少消费。	钱
想要有钱应该要就业。	钱
想要有钱应该要巴结上司。	钱
想要有钱应该要巴结老板。	钱
想要有钱应该要帮助弱势。	钱
想要有钱应该要开发商机。	钱
想要有钱应该要开展副业。	钱
想要有钱应该要开源节流。	钱
想要有钱应该要当上老板。	钱
想要有钱应该要当官。	钱
想要有钱应该要当家教。	钱
想要有钱应该要当小偷。	钱
想要有钱应该要当小白脸。	钱
想要有钱应该要当总统。	钱
想要有钱应该要当掉贵重物品。	钱
想要有名应该要当明星。	名
想要有钱应该要当老师。	钱
想要有钱应该要当老板。	钱
想要有钱应该要当街头艺人。	钱
想要有钱应该要很聪明。	钱
想要有钱应该要忍到发薪水日。	钱
想要有钱应该要念书。	钱
想要有钱应该要想办法。	钱
想要有钱应该要懂得开源节流。	钱
想要有钱应该要懂得投资。	钱
想要有钱应该要懂得理财。	钱
想要有钱应该要懂得精打细算。	钱
想要有钱应该要懂的投资。	钱
想要有钱应该要成功。	钱
想要有钱应该要打拼事业。	钱
想要有钱应该要找份好工作。	钱
想要有钱应该要找兼职。	钱
想要有钱应该要找到好工作。	钱
想要有钱应该要找好工作。	钱
想要有钱应该要找好的工作。	钱
想要有钱应该要找对工作。	钱
想要有钱应该要找机会。	钱
想要有钱应该要找老板。	钱
想要有钱应该要找高薪工作。	钱
想要有钱应该要把握机会。	钱
想要有钱应该要投稿。	钱
想要有钱应该要投资买股票。	钱
想要有钱应该要投资房地产。	钱
想要有钱应该要投资正确。	钱
想要有钱应该要投资理财。	钱
想要有钱应该要投资股票。	钱
想要有钱应该要抢劫。	钱
想要有钱应该要抢银行。	钱
想要有钱应该要拍卖。	钱
想要有钱应该要拍卖物品。	钱
想要有钱应该要拼命工作。	钱
想要有钱应该要拼命念书。	钱
想要有钱应该要拼命赚。	钱
想要有钱应该要拿奖金。	钱
想要有钱应该要挖到金矿山。	钱
想要有钱应该要控制支出。	钱
想要有钱应该要搞投机生意。	钱
想要有钱应该要智慧。	钱
想要有钱应该要有一技之长。	钱
想要有钱应该要有个好爸爸。	钱
想要有钱应该要有创意。	钱
想要有钱应该要有商业头脑。	钱
想要有钱应该要有头脑。	钱
想要有钱应该要有好工作。	钱
想要有钱应该要有工作。	钱
想要有钱应该要有权。	钱
想要有钱应该要有理想。	钱
想要有钱应该要有生意头脑。	钱
想要有钱应该要有眼光。	钱
想要有钱应该要有知识。	钱
想要有钱应该要正当的赚。	钱
想要有钱应该要正确投资。	钱
想要有钱应该要正确理财。	钱
想要有钱应该要毅力。	钱
想要有钱应该要比别人更强。	钱
想要有钱应该要比赛拿奖金。	钱
想要有钱应该要求老板加薪。	钱
想要有钱应该要消费。	钱
想要有钱应该要炒地皮。	钱
想要有钱应该要炒房地产。	钱
想要有钱应该要炒股。	钱
想要有钱应该要炒股票。	钱
想要有钱应该要理财。	钱
想要有钱应该要理财规划。	钱
想要有钱应该要用功。	钱
想要有钱应该要用功念书。	钱
想要有钱应该要用功读书。	钱
想要有钱应该要用心工作。	钱
想要有钱应该要用心赚。	钱
想要有钱应该要用脑。	钱
想要有钱应该要申请奖学金。	钱
想要有钱应该要省一点。	钱
想要有钱应该要省吃俭用。	钱
想要有钱应该要省吃检用。	钱
想要有钱应该要看准投资方向。	钱
想要有钱应该要积德。	钱
想要有钱应该要积极进取。	钱
想要有钱应该要签乐透。	钱
想要有钱应该要签六合彩。	钱
想要有钱应该要精打细算。	钱
想要有钱应该要细心。	钱
想要有钱应该要考公职。	钱
想要有钱应该要耍心机。	钱
想要有钱应该要聪明。	钱
想要有钱应该要聪明投资。	钱
想要有钱应该要肯吃苦。	钱
想要有钱应该要脚踏实地。	钱
想要有钱应该要自己加油。	钱
想要有钱应该要自己慢慢存。	钱
想要有钱应该要自己赚。	钱
想要有酒应该要自己酿。	酒
想要有钱应该要自立自强。	钱
想要有钱应该要自行创业。	钱
想要有钱应该要节俭。	钱
想要有钱应该要节流。	钱
想要有钱应该要节省。	钱
想要有钱应该要节省一点。	钱
想要有钱应该要节省开支。	钱
想要有钱应该要节省开销。	钱
想要有钱应该要节省花。	钱
想要有钱应该要节省花费。	钱
想要有钱应该要花更少。	钱
想要有钱应该要行商。	钱
想要有钱应该要被包养。	钱
想要有钱应该要观看股市投资。	钱
想要有钱应该要规划投资。	钱
想要有钱应该要认真上进。	钱
想要有钱应该要认真唸书。	钱
想要有钱应该要认真工作。	钱
想要有钱应该要认真念书。	钱
想要有钱应该要认真读书。	钱
想要有钱应该要认真赚。	钱
想要有钱应该要讨好老板。	钱
想要有钱应该要讯息广。	钱
想要有钱应该要试着投资。	钱
想要有钱应该要试试大乐透。	钱
想要有钱应该要试试彩券。	钱
想要有钱应该要诚实。	钱
想要有钱应该要读书。	钱
想要有钱应该要赌博。	钱
想要有钱应该要赚更多。	钱
想要有钱应该要跟人借。	钱
想要有钱应该要跟妈妈拿。	钱
想要有钱应该要跟父母要。	钱
想要有钱应该要跟爸爸拿。	钱
想要有钱应该要踏实。	钱
想要有钱应该要身体力行。	钱
想要有钱应该要辛勤工作。	钱
想要有钱应该要辛苦工作。	钱
想要有钱应该要运用知识。	钱
想要有钱应该要进修。	钱
想要有钱应该要进行营利行为。	钱
想要有钱应该要远见。	钱
想要有钱应该要送人。	钱
想要有钱应该要适当投资。	钱
想要有钱应该要避免浪费。	钱
想要有钱应该要量入为出。	钱
想要有树应该要阻止滥伐。	树
想要有钱应该要陪酒。	钱
想要有钱应该要领奖学金。	钱
想要有主人的爱应该要乖。	乖
想要有双眼皮应该要割。	割
想要有可爱的猫应该要买。	买
想要有好的成绩应该要拼。	拼
想要有宠物应该要买。	买
想要有小孩应该要生。	生
想要有布丁应该要买。	买
想要有快乐的心情应该要笑。	笑
想要有温泉券应该要买。	买
想要有肌肉应该要练。	练
想要有肥料应该要买。	买
想要有背包应该要买。	买
想要有自动笔应该要买。	买
想要有衣服应该要买。	买
想要有黄金应该要买。	买
打世纪帝国二的时候会想要赢。	赢
打手球的时候会想要赢。	赢
打比赛的时候会想要赢。	赢
打球的时候会想要赢。	赢
打电动是为了爽。	爽
打电动的时候会想要赢。	赢
折飞机是为了玩。	玩
掰咖的时候会想要哭。	哭
收到无辜罚单的时候会想要哭。	哭
旅游是为了玩。	玩
旅游的时候会想要玩。	玩
无助的时候会想要哭。	哭
有钱的时候会想要玩。	玩
毕业的时候会想要哭。	哭
气到不行的时候会想要哭。	哭
没自信的时候会想要哭。	哭
泡泡面是为了吃。	吃
洗牌的时候会想要赢。	赢
烦闷的时候会想要玩。	玩
煮饭是为了吃。	吃
玩游戏的时候会想要赢。	赢
男友打我的时候会想要哭。	哭
疲累的时候会想要睡。	睡
眼睛瞎掉的时候会想要哭。	哭
种菜是为了吃。	吃
考不好的时候会想要哭。	哭
考试成绩差的时候会想要哭。	哭
肠胃炎的时候会想要吐。	吐
背部痒的时候会想要抓。	抓
脚底板很痒的时候会想要抓。	抓
落榜的时候会想要哭。	哭
衣服脏了的时候会想要洗。	洗
被人排挤的时候会想要哭。	哭
被家人背叛的时候会想要哭。	哭
被狗追的时候会想要跑。	跑
被背叛的时候会想要哭。	哭
被蚊子叮的时候会想要抓。	抓
被骂的时候会想要哭。	哭
觉得失望的时候会想要哭。	哭
觉得开心的时候会想要笑。	笑
觉得快乐的时候会想要笑。	笑
觉得悲伤的时候会想要哭。	哭
觉得被冤枉的时候会想要哭。	哭
觉得难过的时候会想要哭。	哭
觉得高兴的时候会想要笑。	笑
贪污是为了钱。	钱
超累的时候会想要睡。	睡
跟朋友吵架的时候会想要哭。	哭
输了的时候会想要哭。	哭
心会一直跳动。	心
雨会下一阵子。	雨
雨会下个不停。	雨
雪会下在高山上。	雪
心会不断跳动。	心
狗会乱叫。	狗
狗会乱咬东西。	狗
人会乱说话。	人
人会争吵。	人
人会交际。	人
人会享受美食。	人
风会令人凉爽。	风
雷会伴随闪电。	雷
雪会使人感觉冷。	雪
哭会使视线模煳。	哭
鸟会停在电线杆上。	鸟
牛会冲向红色。	牛
花会凋谢。	花
花会凋零。	花
氧会助燃。	氧
猫会卷成一团取暖。	猫
火会发光。	火
人会发薪水。	人
水会变冰。	水
云会变化。	云
水会变成冰块。	水
雪会变成水。	雪
铃会叮叮响。	铃
狗会吃屎。	狗
人会吃零食。	人
猪会吃馊水。	猪
狗会吃骨头。	狗
猫会吃鱼。	猫
人会后悔。	人
狗会吐舌头。	狗
蛇会吞食。	蛇
花会含苞待放。	花
狗会含骨头。	狗
狗会听主人的话。	狗
狗会听话。	狗
叫会吵人。	叫
叫会吵到人。	叫
叫会吵到其他人。	叫
叫会吵到邻居。	叫
人会吵架。	人
花会吸引蜜蜂。	花
花会吸引蝴蝶。	花
鸡会咕咕叫。	鸡
狗会咬小偷。	狗
猫会咬尾巴。	猫
狗会咬骨头。	狗
人会哭泣。	人
狗会啃骨头。	狗
鸡会啄人。	鸡
鸡会啄米。	鸡
鸡会啼叫。	鸡
跑会喘。	跑
渴会喝茶。	渴
笑会嘴角上扬。	笑
猪会噗噗叫。	猪
人会回答问题。	人
狗会在路边洒尿。	狗
猫会埋大便。	猫
恨会增加烦恼。	恨
跳会增强腿部肌肉。	跳
书会增进知识。	书
狗会大叫。	狗
人会学习思考。	人
蛋会孵化。	蛋
蛋会孵化成小鸡。	蛋
狗会守门。	狗
人会害怕寂寞。	人
人会寂寞。	人
狗会对主人忠心。	狗
狗会导盲。	狗
钱会带来财富。	钱
灯会帮助照明。	灯
笑会延年益寿。	笑
人会建立制度。	人
花会引来蝴蝶。	花
火会引燃。	火
人会当阿宅。	人
水会往下流。	水
痛会很不舒服。	痛
火会很烫。	火
海会很蓝。	海
跑会心跳变快。	跑
狗会忠心耿耿。	狗
人会念经。	人
人会怀疑。	人
人会惋惜。	人
人会想像。	人
渴会想喝水。	渴
人会感动。	人
渴会找饮料。	渴
风会把树吹倒。	风
风会把纸吹走。	风
猫会抓伤人。	猫
人会抓住机会。	人
猫会抓老鼠。	猫
狗会护主。	狗
鸡会拍翅膀。	鸡
狗会拼命摇尾巴。	狗
心会持续跳动。	心
蛇会挂在树上。	蛇
人会挑战。	人
人会捐钱。	人
狗会捡飞盘。	狗
哭会掉眼泪。	哭
人会探索。	人
狗会接球。	狗
水会接近无限透明。	水
狗会接飞盘。	狗
狗会摇尾巴。	狗
花会摇曳。	花
车会撞人。	车
树会放出氧气。	树
云会散去。	云
狗会旺旺叫。	狗
笑会是件开心的事。	笑
狗会替主人看家。	狗
树会有年轮。	树
人会有恩怨情仇。	人
人会有气质。	人
海会有浪。	海
海会有漩涡。	海
海会有潮起潮落。	海
人会有知识。	人
人会有道德。	人
花会有香味。	花
花会枯萎。	花
蛇会毒人。	蛇
狗会汪汪汪。	狗
水会沸腾。	水
雨会洗净大地。	雨
水会流向大海。	水
哭会流眼泪。	哭
哭会流鼻水。	哭
哭会流鼻涕。	哭
水会淹死人。	水
鸭会游水。	鸭
水会滋养大地。	水
水会滴下来。	水
水会灌溉农作物。	水
火会烧毁房子。	火
火会煮熟东西。	火
火会熄灭。	火
火会燃烧。	火
火会燃烧物品。	火
火会燎原。	火
人会犯罪。	人
狗会狂叫。	狗
狗会玩你丢我捡。	狗
猫会玩毛线球。	猫
钱会生利息。	钱
铁会生锈。	铁
跳会用力。	跳
人会用火。	人
鸭会用蹼滑水。	鸭
鸭会用蹼走路。	鸭
人会盖房子。	人
花会盛开。	花
狗会看家。	狗
狗会看家门。	狗
狗会看门。	狗
鸡会短暂飞翔。	鸡
人会社交。	人
跳会离地。	跳
人会空手道。	人
水会穿石。	水
人会穿衣服。	人
水会穿透石头。	水
线会系在针上。	线
水会结冰。	水
水会结冻。	水
水会结成冰。	水
虫会结茧。	虫
花会绽放。	花
人会缝衣服。	人
猫会舔手脚。	猫
猫会舔自己。	猫
猫会舔自己梳毛。	猫
猫会舔自己的毛。	猫
钱会花完。	钱
水会蒸发。	水
虫会蠕动。	虫
树会行光合作用。	树
猪会被人饲养。	猪
水会解渴。	水
狗会认主人。	狗
死会让人悲伤。	死
叫会让喉咙痛。	叫
哭会让眼睛红肿。	哭
水会让身体湿掉。	水
水会让铁生锈。	水
人会访问。	人
人会说错话。	人
海会调节温度。	海
人会购物。	人
猫会走路无声。	猫
海会起大浪。	海
心会跳动。	心
水会载舟。	水
球会进篮框。	球
人会追求梦想。	人
水会遇冷凝结。	水
水会遇冷结冰。	水
水会遇热气化。	水
云会遮住太阳。	云
云会遮住月亮。	云
笑会释放压力。	笑
树会释放氧气。	树
狗会闻东西。	狗
人会阅读。	人
花会随着季节绽放。	花
云会飘。	云
雪会飘落。	雪
鸟会飞翔。	鸟
鸟会飞起来。	鸟
蝉会鸣叫。	蝉
天会黑。	天
人能做的事情有上学。	人
人能做的事情有上课。	人
人能做的事情有下棋。	人
人能做的事情有交朋友。	人
人能做的事情有享受生活。	人
钱能做的事情有付帐。	钱
人能做的事情有促进世界和平。	人
狗能做的事情有保护主人。	狗
人能做的事情有保护生态。	人
人能做的事情有修水管。	人
人能做的事情有修电脑。	人
人能做的事情有倒垃圾。	人
狗能做的事情有做伴。	狗
人能做的事情有做功课。	人
人能做的事情有做善事。	人
人能做的事情有做好榜样。	人
人能做的事情有做实验。	人
人能做的事情有做运动。	人
人能做的事情有做饭。	人
树能做的事情有光合作用。	树
人能做的事情有养狗。	人
人能做的事情有养猪。	人
人能做的事情有养猫。	人
人能做的事情有写信。	人
人能做的事情有写暑假作业。	人
人能做的事情有写歌。	人
人能做的事情有出国。	人
人能做的事情有出版刊物。	人
人能做的事情有创业。	人
人能做的事情有创作。	人
人能做的事情有创造。	人
人能做的事情有制作道具。	人
水能做的事情有制冰。	水
人能做的事情有剪指甲。	人
人能做的事情有升学。	人
狗能做的事情有协助搜救。	狗
狗能做的事情有协助缉毒。	狗
牛能做的事情有反刍。	牛
人能做的事情有发明。	人
人能做的事情有发明东西。	人
人能做的事情有发明产品。	人
人能做的事情有发现创作。	人
风能做的事情有发电。	风
蚕能做的事情有变成蛹。	蚕
蚕能做的事情有变成蛾。	蚕
鸡能做的事情有叫人起床。	鸡
蚕能做的事情有吃桑叶。	蚕
猫能做的事情有吃老鼠。	猫
鸟能做的事情有吃谷粒。	鸟
蚕能做的事情有吐丝。	蚕
人能做的事情有吐槽。	人
狗能做的事情有吓走小偷。	狗
狗能做的事情有吓跑坏人。	狗
猫能做的事情有咪咪叫。	猫
狗能做的事情有咬坏人。	狗
牛能做的事情有哞哞叫。	牛
鸟能做的事情有啾啾叫。	鸟
鸟能做的事情有喳喳叫。	鸟
人能做的事情有器官捐赠。	人
人能做的事情有团结合作。	人
鸟能做的事情有在天上飞。	鸟
鸟能做的事情有在天空中飞翔。	鸟
人能做的事情有在家上网。	人
狗能做的事情有在机场闻毒品。	狗
人能做的事情有娱乐。	人
人能做的事情有学习。	人
狗能做的事情有守门口。	狗
酒能做的事情有宿醉。	酒
人能做的事情有工作赚钱。	人
水能做的事情有帮人解渴。	水
狗能做的事情有帮忙追坏人。	狗
人能做的事情有建立城市。	人
人能做的事情有弹吉他。	人
手能做的事情有弹琴。	手
人能做的事情有当政客。	人
狗能做的事情有当警犬。	狗
鸡能做的事情有当闹钟。	鸡
人能做的事情有微笑。	人
狗能做的事情有忠心陪伴。	狗
人能做的事情有恋爱。	人
人能做的事情有想念。	人
狗能做的事情有战斗。	狗
人能做的事情有戴隐形眼镜。	人
人能做的事情有打工赚钱。	人
人能做的事情有打扫家里。	人
人能做的事情有打牌。	人
人能做的事情有打球吃饭睡觉。	人
人能做的事情有打电动。	人
人能做的事情有打篮球。	人
手能做的事情有打键盘。	手
人能做的事情有扫地。	人
狗能做的事情有找东西。	狗
人能做的事情有找工作。	人
熊能做的事情有找蜂蜜。	熊
钱能做的事情有投资。	钱
牛能做的事情有拉犁。	牛
人能做的事情有拖地。	人
树能做的事情有招风。	树
手能做的事情有拿筷子。	手
人能做的事情有挑水。	人
猫能做的事情有捉老鼠。	猫
鸟能做的事情有捉虫。	鸟
钱能做的事情有捐献。	钱
手能做的事情有揉眼睛。	手
羊能做的事情有提供毛。	羊
手能做的事情有握麦克风。	手
狗能做的事情有搜寻毒品。	狗
狗能做的事情有搜救。	狗
手能做的事情有摸摸头。	手
人能做的事情有撑竿跳。	人
人能做的事情有改变世界。	人
手能做的事情有敲电脑键盘。	手
人能做的事情有整理家务。	人
人能做的事情有旅游。	人
人能做的事情有旅行。	人
鸡能做的事情有晨啼。	鸡
鸟能做的事情有替大树抓坏虫。	鸟
狗能做的事情有查毒品。	狗
树能做的事情有水土保持。	树
狗能做的事情有汪汪。	狗
水能做的事情有洗手。	水
人能做的事情有洗碗。	人
水能做的事情有洗碗盘。	水
水能做的事情有洗米。	水
水能做的事情有浇花。	水
狗能做的事情有牧羊。	狗
狗能做的事情有狂吠。	狗
鱼能做的事情有用腮唿吸。	鱼
鱼能做的事情有用鳃唿吸。	鱼
鱼能做的事情有用鳃换气。	鱼
笔能做的事情有画图。	笔
蚕能做的事情有结茧。	蚕
狗能做的事情有舔骨头。	狗
鱼能做的事情有被钓。	鱼
碗能做的事情有装水果。	碗
水能做的事情有调节大气气候。	水
车能做的事情有超速行驶。	车
猫能做的事情有跟狗打架。	猫
水能做的事情有载舟覆舟。	水
车能做的事情有载货物。	车
猫能做的事情有追老鼠。	猫
狗能做的事情有顾门。	狗
狗能做的事情有顾门口。	狗
上网会笑。	笑
不幸会哭。	哭
丧事能做的事情有哭。	哭
中暑会热。	热
亲人过世会哭。	哭
休息能做的事情有睡。	睡
伤口会痛。	痛
伤心时会哭。	哭
伤心能做的事情有哭。	哭
兄弟姊妹能做的事情有玩。	玩
冬天会冷。	冷
冬眠能做的事情有睡。	睡
吃宵夜会胖。	胖
和朋友在一起能做的事情有玩。	玩
喝农药可能会死。	死
噪音会吵。	吵
地球仪会转。	转
地球会转。	转
夏天会热。	热
大吃会胖。	胖
失恋时会哭。	哭
失恋能做的事情有哭。	哭
小蝴蝶会飞。	飞
心情好会笑。	笑
心痛会哭。	哭
心脏病发可能会死。	死
忧郁时能做的事情有哭。	哭
快乐会笑。	笑
快乐的人会笑。	笑
悲伤的时候会哭。	哭
悲伤能做的事情有哭。	哭
感动时能做的事情有哭。	哭
感动能做的事情有哭。	哭
手电筒会亮。	亮
打扫会累。	累
打球打太久会累。	累
放屁会臭。	臭
晚上能做的事情有睡。	睡
有人大叫会吵。	吵
有钱能做的事情有玩。	玩
服药过量可能会死。	死
没钱会穷。	穷
游乐园能做的事情有玩。	玩
热水会烫。	烫
疲劳能做的事情有睡。	睡
疲惫能做的事情有睡。	睡
直升机能做的事情有飞。	飞
看到恶心的东会吐。	吐
看喜剧会笑。	笑
看喜剧片会笑。	笑
看感人电影会哭。	哭
落榜会哭。	哭
蛀牙会痛。	痛
蜘蛛能做的事情有爬。	爬
蝴蝶会飞。	飞
螃蟹会爬。	爬
袋鼠会跳。	跳
赶时间的人会跑。	跑
跳淡水河自杀会死。	死
过期太久食品会坏。	坏
过生日会笑。	笑
陀螺会转。	转
难过时能做的事情有哭。	哭
难过的时候会哭。	哭
雁鹅能做的事情有飞。	飞
风筝会飞。	飞
飞机起飞会吵。	吵
食物放久了会坏。	坏
鼻子能做的事情有闻。	闻
中药是苦的。	苦
优酪乳是甜的。	甜
伤口是痛的。	痛
冬天是冷的。	冷
在冬天吃冰是冷的。	冷
心碎是痛的。	痛
搬家是累的。	累
方糖是甜的。	甜
朝天椒是辣的。	辣
果冻是甜的。	甜
棒棒糖是甜的。	甜
热水是烫的。	烫
牛奶糖是甜的。	甜
甘蔗是甜的。	甜
盐酥鸡是咸的。	咸
糖水是甜的。	甜
糖浆是甜的。	甜
舌头是软的。	软
药粉是苦的。	苦
西药是苦的。	苦
黄莲是苦的。	苦
黑巧克力是苦的。	苦
胖会让你想要不吃宵夜。	胖
穷会让你想要中奖。	穷
热会让你想要乘凉。	热
穷会让你想要乞讨。	穷
钱会让你想要买东西。	钱
冷会让你想要买外套。	冷
冷会让你想要买暖暖包。	冷
冷会让你想要保暖。	冷
冷会让你想要冬眠。	冷
热会让你想要冷气。	热
胖会让你想要减肥。	胖
冷会让你想要出国避寒。	冷
钱会让你想要努力工作。	钱
冷会让你想要取暖。	冷
胖会让你想要变瘦。	胖
饿会让你想要吃便当。	饿
热会让你想要吃冰棒。	热
饿会让你想要吃夜点。	饿
饿会让你想要吃大餐。	饿
饿会让你想要吃棉花糖。	饿
饿会让你想要吃波卡。	饿
饿会让你想要吃点心。	饿
冷会让你想要吃热食。	冷
饿会让你想要吃菜。	饿
饿会让你想要吃零食。	饿
饿会让你想要吃面。	饿
饿会让你想要吃面包。	饿
饿会让你想要吃饼干。	饿
饿会让你想要吃麦当劳。	饿
冷会让你想要吹暖气。	冷
热会让你想要吹电扇。	热
热会让你想要吹电风扇。	热
冷会让你想要喝热汤。	冷
冷会让你想要多穿衣服。	冷
热会让你想要大口大口吃冰。	热
热会让你想要天气冷。	热
冷会让你想要天气热。	冷
钱会让你想要存起来。	钱
热会让你想要开冷气。	热
冷会让你想要开暖炉。	冷
热会让你想要开电扇。	热
热会让你想要开电风扇。	热
钱会让你想要投资。	钱
痒会让你想要抠。	痒
痒会让你想要抠耳朵。	痒
热会让你想要搧扇子。	热
热会让你想要搧风。	热
累会让你想要放假。	累
累会让你想要放松。	累
累会让你想要散步。	累
丑会让你想要整型。	丑
累会让你想要旅行。	累
冷会让你想要暖暖包。	冷
热会让你想要沖冷水。	热
热会让你想要沖冷水澡。	热
热会让你想要洗冷水澡。	热
饿会让你想要煮饭。	饿
热会让你想要玩水。	热
冷会让你想要用暖暖包。	冷
胖会让你想要瘦身。	胖
冷会让你想要盖被子。	冷
穷会让你想要省钱。	穷
飞会让你想要翅膀。	飞
热会让你想要脱。	热
胖会让你想要节食。	胖
钱会让你想要花掉。	钱
饿会让你想要觅食。	饿
胖会让你想要让自己变瘦。	胖
穷会让你想要赚钱。	穷
热会让你想要跑冷水澡。	热
冷会让你想要躲在棉被里。	冷
冷会让你想要躲在被窝。	冷
冷会让你想要躲在被窝里。	冷
冷会让你想要进室内。	冷
热会让你想要降温。	热
饿会让你想要饼干。	饿
与爱人分离会让你想要哭。	哭
亲人过世会让你想要哭。	哭
亲人逝去会让你想要哭。	哭
伤心时会让你想要哭。	哭
做作会让你想要吐。	吐
儿童乐园会让你想要玩。	玩
出车祸会让你想要哭。	哭
分手会让你想要哭。	哭
分手信会让你想要哭。	哭
分手时会让你想要哭。	哭
切洋葱会让你想要哭。	哭
压力会让你想要哭。	哭
压力大会让你想要哭。	哭
发现碗里有虫会让你想要吐。	吐
口渴会让你想要喝。	喝
吃蟑螂会让你想要吐。	吐
听相声会让你想要笑。	笑
告白失败会让你想要哭。	哭
和暗恋对象坐会让你想要笑。	笑
喜剧会让你想要笑。	笑
太感动会让你想要哭。	哭
太操劳会让你想要睡。	睡
太累会让你想要睡。	睡
太肥会让你想要瘦。	瘦
失业会让你想要哭。	哭
失去亲人会让你想要哭。	哭
失去会让你想要哭。	哭
失去恋情发展会让你想要哭。	哭
失恋时会让你想要哭。	哭
失火会让你想要逃。	逃
头发剪坏了会让你想要哭。	哭
妈妈死了会让你想要哭。	哭
委屈会让你想要哭。	哭
娶老婆会让你想要笑。	笑
宠物死掉会让你想要哭。	哭
害喜会让你想要吐。	吐
家破人亡会让你想要哭。	哭
寿司会让你想要吃。	吃
开心的事情会让你想要笑。	笑
很累会让你想要睡。	睡
得意会让你想要笑。	笑
快乐时会让你想要笑。	笑
怀孕了会让你想要吐。	吐
怀孕会让你想要吐。	吐
恶心会让你想要吐。	吐
悲伤的时候会让你想要哭。	哭
悲剧会让你想要哭。	哭
想家会让你想要哭。	哭
愉悦会让你想要笑。	笑
感人的剧情会让你想要哭。	哭
感伤会让你想要哭。	哭
感动会让你想要哭。	哭
感动的时候会让你想要哭。	哭
成绩不好会让你想要哭。	哭
打比赛输了会让你想要哭。	哭
拿羽毛搔脚会让你想要笑。	笑
拿零分会让你想要哭。	哭
搔痒会让你想要笑。	笑
摔车会让你想要哭。	哭
撞到头会让你想要哭。	哭
撞到头很痛会让你想要哭。	哭
撞到鼻子会让你想要哭。	哭
晕车会让你想要吐。	吐
没工作会让你想要哭。	哭
没有钱会让你想要哭。	哭
没钱会让你想要哭。	哭
沮丧会让你想要哭。	哭
洋葱会让你想要哭。	哭
烤肉会让你想要吃。	吃
爆浆的小强会让你想要吐。	吐
爸爸死了会让你想要哭。	哭
玩game会让你想要赢。	赢
生离死别会让你想要哭。	哭
疲劳会让你想要睡。	睡
痛苦的时候会让你想要哭。	哭
看喜剧会让你想要笑。	笑
看悲剧的时候会让你想要哭。	哭
看悲剧的电影会让你想要哭。	哭
看海角七号会让你想要哭。	哭
离别会让你想要哭。	哭
离开会让你想要哭。	哭
累的时候会让你想要睡。	睡
结束感情会让你想要哭。	哭
绝望会让你想要哭。	哭
美食会让你想要吃。	吃
考不及格会让你想要哭。	哭
考不好会让你想要哭。	哭
考最后一名会让你想要哭。	哭
考试不及格会让你想要哭。	哭
考试满分会让你想要笑。	笑
考试考不好会让你想要哭。	哭
考试考差会让你想要哭。	哭
考零分会让你想要哭。	哭
肥女的油头发会让你想要吐。	吐
脚趾头撞桌脚会让你想要哭。	哭
腰被搔痒会让你想要笑。	笑
舌燥会让你想要喝。	喝
落榜会让你想要哭。	哭
落选会让你想要哭。	哭
被冤枉会让你想要哭。	哭
被喷胡椒喷雾会让你想要哭。	哭
被打的时候会让你想要哭。	哭
被抛弃会让你想要哭。	哭
被甩会让你想要哭。	哭
被诬陷会让你想要哭。	哭
被误会会让你想要哭。	哭
被责骂会让你想要哭。	哭
赌博会让你想要赢。	赢
踢足球会让你想要赢。	赢
输钱会让你想要赢。	赢
通过考试会让你想要笑。	笑
难过时会让你想要哭。	哭
难过的时候会让你想要哭。	哭
饮料会让你想要喝。	喝
鲜奶茶会让你想要喝。	喝
冷之后可能会发生的事情是感冒。	冷
饿之后可能会发生的事情是找食物。	饿
冷之后可能会发生的事情是穿厚衣服。	冷
冷之后可能会发生的事情是穿毛衣。	冷
累之后可能会发生的事情是躺着不动。	累
累会让你不想动。	累
冷会让你加衣服。	冷
书会让你博学多闻。	书
穷会让你喜欢有钱。	穷
酒会让你喝醉。	酒
累会让你四肢无力。	累
书会让你增加知识。	书
冷会让你想穿外套。	冷
累会让你打瞌睡。	累
饿会让你找餐厅吃饭。	饿
累会让你无精打彩。	累
累会让你昏昏沉沉。	累
书会让你有智慧。	书
热会让你流汗。	热
药会让你病好。	药
打会让你痛。	打
哭会让你眼泪一直掉。	哭
哭会让你眼睛红。	哭
累会让你睡。	累
死会让你解脱。	死
钱会让你贪婪。	钱
冷会让你起鸡皮疙瘩。	冷
酒会让你醉。	酒
药可能会带来副作用。	药
睡可能会带来好肤质。	睡
酒可能会带来宿醉。	酒
光可能会带来影子。	光
书可能会带来智慧。	书
哭可能会带来泪水。	哭
狗可能会带来狂犬病。	狗
哭可能会带来眼泪。	哭
书可能会带来知识。	书
云可能会带来降雨。	云
花可能会带来香气。	花
一直睡觉可能会带来累。	累
七夕分手之后可能会发生的事情是哭。	哭
中奖可能会带来钱。	钱
乌云可能会带来雨。	雨
乐透可能会带来钱。	钱
乐透彩可能会带来钱。	钱
买上市股票可能会带来钱。	钱
买乐透彩可能会带来钱。	钱
买刮刮卡可能会带来钱。	钱
买基金可能会带来钱。	钱
买彩券可能会带来钱。	钱
买股票可能会带来钱。	钱
乱花钱之后可能会发生的事情是穷。	穷
亲人过世会让你哭。	哭
亲友过世会让你哭。	哭
伤心歌曲会让你哭。	哭
做善事可能会带来福。	福
入不敷出之后可能会发生的事情是穷。	穷
写作业会让你累。	累
分手会让你哭。	哭
分离会让你哭。	哭
切洋葱会让你哭。	哭
刮刮乐可能会带来钱。	钱
刮刮卡可能会带来钱。	钱
加班会让你累。	累
卖东西可能会带来钱。	钱
卖鸡排可能会带来钱。	钱
吃完大便之后可能会发生的事情是吐。	吐
吃屎可能会引起吐。	吐
喉咙痛之后可能会发生的事情是咳。	咳
喜剧会让你笑。	笑
喜欢的人会让你笑。	笑
因为胖所以BMI值偏高。	胖
因为热所以一直流汗。	热
因为穷所以三餐不继。	穷
因为懒所以不整理房间。	懒
因为热所以中暑。	热
因为渴所以买矿泉水。	渴
因为冷所以冬眠。	冷
因为胖所以减肥。	胖
因为饿所以出门买午餐。	饿
因为累所以去休息。	累
因为饿所以去夜市。	饿
因为热所以吃冰消暑。	热
因为饿所以吃面包。	饿
因为饿所以吃饼干。	饿
因为热所以吹冷气。	热
因为冷所以吹暖气。	冷
因为热所以吹电扇。	热
因为渴所以喝汽水。	渴
因为冷所以喝热饮。	冷
因为渴所以喝绿茶花。	渴
因为冷所以围围巾。	冷
因为累所以小憩片刻。	累
因为累所以小睡一会儿。	累
因为热所以开冷气。	热
因为冷所以开暖气。	冷
因为热所以开电扇。	热
因为热所以开电风扇。	热
因为累所以想休息。	累
因为累所以想停止工作。	累
因为胖所以想减肥。	胖
因为饿所以想吃。	饿
因为饿所以想吃东西。	饿
因为热所以想吃冰。	热
因为饿所以想吃饭。	饿
因为热所以想吹冷气。	热
因为恨所以想要报复。	恨
因为累所以想趴下来。	累
因为累所以想闭眼。	累
因为冷所以戴手套。	冷
因为冷所以戴毛帽。	冷
因为冷所以戴耳罩。	冷
因为累所以打盹。	累
因为脏所以扫地。	脏
因为渴所以找水。	渴
因为饿所以找餐厅。	饿
因为脏所以擦干净。	脏
因为恨所以无法原谅。	恨
因为恨所以无法谅解。	恨
因为饿所以泡泡面。	饿
因为热所以洗冷水澡。	热
因为脏所以清扫。	脏
因为脏所以清洁。	脏
因为脏所以清理。	脏
因为饿所以煮菜。	饿
因为饿所以煮饭。	饿
因为冷所以盖棉被。	冷
因为冷所以盖被子。	冷
因为哭所以眼睛肿。	哭
因为累所以睡一下。	累
因为冷所以穿外套。	冷
因为哭所以红了双眼。	哭
因为饿所以肚子叫。	饿
因为饿所以肚子在叫。	饿
因为热所以脱外套。	热
因为热所以脱衣服。	热
因为哭所以要人安慰。	哭
因为累所以要休息。	累
因为胖所以要减肥。	胖
因为饿所以要吃饭。	饿
因为冷所以要喝热水。	冷
因为饿所以觅食。	饿
因为饿所以订餐。	饿
因为累所以躺。	累
因为累所以躺在床上。	累
因为累所以躺着。	累
因为三天没吃饭所以饿。	饿
因为吃很多所以饱。	饱
因为吃超多所以饱。	饱
因为喜悦所以笑。	笑
因为太久没吃所以饿。	饿
因为太害怕了所以哭。	哭
因为太阳大所以热。	热
因为失去亲人所以哭。	哭
因为宠物过世所以哭。	哭
因为寒流所以冷。	冷
因为寒流来所以冷。	冷
因为工作一天所以累。	累
因为工作操劳所以累。	累
因为开了太久的会所以累。	累
因为很伤心所以哭。	哭
因为很感伤所以哭。	哭
因为很难过所以哭。	哭
因为快考试了所以烦。	烦
因为悲伤所以哭。	哭
因为情伤所以哭。	哭
因为想家所以哭。	哭
因为想念所以哭。	哭
因为愉快所以笑。	笑
因为撞到所以痛。	痛
因为操劳过度所以累。	累
因为早餐没吃所以饿。	饿
因为昨天晚上没睡所以累。	累
因为有寒流所以冷。	冷
因为没冷气所以热。	热
因为没吃东西所以饿。	饿
因为没吃所以饿。	饿
因为没吃早餐所以饿。	饿
因为没吃饭所以饿。	饿
因为没开冷气所以热。	热
因为没有休息所以累。	累
因为没有保暖所以冷。	冷
因为没水喝所以渴。	渴
因为没盖被子所以冷。	冷
因为没穿外套所以冷。	冷
因为没穿衣服所以冷。	冷
因为滑倒所以痛。	痛
因为爱吃所以胖。	胖
因为玩了一整天所以累。	累
因为疼痛所以哭。	哭
因为痛彻心扉所以哭。	哭
因为空腹所以饿。	饿
因为穿太多所以热。	热
因为绝望所以哭。	哭
因为考试熬夜所以累。	累
因为被人欺负所以哭。	哭
因为被所追所以跑。	跑
因为贪吃所以胖。	胖
因为走太多路所以累。	累
因为赶报告所以累。	累
因为过年暴饮暴食所以胖。	胖
因为速食吃太多所以胖。	胖
因为饿了所以吃。	吃
太久没喝水会让你渴。	渴
幸福会让你笑。	笑
幽默的人会让你笑。	笑
得痔疮会让你痛。	痛
心痛会让你哭。	哭
惊吓会让你叫。	叫
感动会让你哭。	哭
打你会让你痛。	痛
抽血会让你痛。	痛
拔牙齿会让你痛。	痛
搔痒会让你笑。	笑
搬家会让你累。	累
撞到电线桿会让你痛。	痛
撞墙壁会让你痛。	痛
断食疗法会让你饿。	饿
晚睡早起会让你累。	累
没吃饱会让你饿。	饿
没钱买食物会让你饿。	饿
没食物会让你饿。	饿
爬山会让你喘。	喘
皮肤病会让你痒。	痒
皮肤过敏会让你痒。	痒
练球会让你累。	累
美好的回忆会让你笑。	笑
蚊子叮会让你痒。	痒
被打会让你怒。	怒
被抛弃会让你哭。	哭
被搔痒会让你笑。	笑
跑长跑会让你累。	累
跑马拉松会让你累。	累
邮差可能会带来信。	信
食物中毒之后可能会发生的事情是吐。	吐
